	Line	ProductDescription	DateTime_Out	Feed	OutputGood	Scrap	Error_Count	Sum_Duration	Sum_Staff
0	1	1	2018-01-02 23:00:00	2230	1674	556	37	788	14
1	1	1	2018-01-03 00:00:00	7460	7398	62	53	830	7
2	1	1	2018-01-03 01:00:00	8324	8208	116	30	868	3
3	1	1	2018-01-03 02:00:00	9796	9828	-32	52	422	3
4	1	1	2018-01-03 03:00:00	9632	9288	344	57	536	3
5	1	1	2018-01-03 04:00:00	9899	9828	71	32	496	3
6	1	1	2018-01-03 05:00:00	8460	8532	-72	62	848	3
7	1	1	2018-01-03 06:00:00	6335	6048	287	50	1376	6
8	1	1	2018-01-03 07:00:00	8443	8424	19	61	878	3
9	1	1	2018-01-03 08:00:00	9244	9126	118	63	542	3
10	1	1	2018-01-03 09:00:00	7912	7722	190	77	1012	3
11	1	1	2018-01-03 10:00:00	8352	8262	90	46	884	3
12	1	1	2018-01-03 11:00:00	9771	9666	105	43	404	3
13	1	1	2018-01-03 12:00:00	7632	7452	180	52	1264	3
14	1	1	2018-01-03 13:00:00	8544	8424	120	58	718	3
15	1	1	2018-01-03 14:00:00	6661	6588	73	80	1360	6
16	1	1	2018-01-03 15:00:00	9024	8856	168	51	628	6
17	1	1	2018-01-03 16:00:00	9207	9072	135	53	620	3
18	1	1	2018-01-03 17:00:00	8819	8802	17	63	704	3
19	1	1	2018-01-03 18:00:00	8296	8046	250	44	4364	3
20	1	1	2018-01-03 21:00:00	8120	8154	-34	1	46	3
21	1	1	2018-01-03 22:00:00	7980	7722	258	42	840	6
22	1	1	2018-01-03 23:00:00	9264	9072	192	25	1052	6
23	1	1	2018-01-04 00:00:00	4488	4320	168	19	900	3
24	1	1	2018-01-04 01:00:00	7796	7614	182	31	1908	3
25	1	1	2018-01-04 02:00:00	9419	9342	77	32	1502	3
26	1	1	2018-01-04 03:00:00	8223	7938	285	69	550	3
27	1	1	2018-01-04 04:00:00	9356	9126	230	75	882	3
28	1	1	2018-01-04 05:00:00	9904	9882	22	29	580	3
29	1	1	2018-01-04 06:00:00	9168	9126	42	25	388	6
30	1	1	2018-01-04 07:00:00	5104	4914	190	47	672	3
31	1	1	2018-01-04 08:00:00	684	540	144	14	17022	3
32	1	1	2018-01-04 09:00:00	7967	7884	83	44	350	3
33	1	1	2018-01-04 10:00:00	2358	2376	-18	27	512	3
34	1	1	2018-01-04 11:00:00	152	162	-10	33	1002	3
35	1	1	2018-01-04 12:00:00	5791	5724	67	48	1066	3
36	1	1	2018-01-04 13:00:00	8924	8748	176	45	532	3
37	1	1	2018-01-04 14:00:00	8240	8262	-22	28	6306	6
38	1	1	2018-01-04 15:00:00	5650	6120	-470	12	842	6
39	1	2	2018-01-04 17:00:00	6066	5616	450	25	854	3
40	1	2	2018-01-04 18:00:00	8280	8100	180	53	978	3
41	1	2	2018-01-04 19:00:00	8100	8046	54	39	458	3
42	1	2	2018-01-04 20:00:00	9710	9558	152	37	492	3
43	1	2	2018-01-04 21:00:00	9584	9504	80	29	894	5
44	1	2	2018-01-04 22:00:00	8263	8316	-53	73	280	4
45	1	2	2018-01-04 23:00:00	10224	10152	72	28	728	4
46	1	2	2018-01-05 00:00:00	8868	8748	120	19	4296	2
47	1	2	2018-01-05 01:00:00	6256	6156	100	5	948	2
48	1	2	2018-01-05 02:00:00	52	54	-2	20	448	2
49	1	2	2018-01-05 03:00:00	9400	9414	-14	35	362	2
50	1	2	2018-01-05 04:00:00	10104	10044	60	66	470	2
51	1	2	2018-01-05 05:00:00	9430	9396	34	76	618	2
52	1	2	2018-01-05 06:00:00	9128	9018	110	129	2846	4
53	1	2	2018-01-05 07:00:00	6946	7416	-470	2	3796	2
54	1	1	2018-01-05 14:00:00	3868	3510	358	22	4638	7
55	1	1	2018-01-05 15:00:00	9980	9828	152	9	1310	7
56	1	1	2018-01-05 16:00:00	9836	9774	62	54	384	5
57	1	1	2018-01-05 17:00:00	10056	10098	-42	26	420	5
58	1	1	2018-01-05 18:00:00	10152	10098	54	32	316	5
59	1	1	2018-01-05 19:00:00	10044	9936	108	90	290	5
60	1	1	2018-01-05 20:00:00	9471	9396	75	49	344	5
61	1	1	2018-01-05 21:00:00	9724	9666	58	50	434	5
62	1	1	2018-01-05 22:00:00	9744	9612	132	77	418	10
63	1	1	2018-01-05 23:00:00	8756	8802	-46	35	506	10
64	1	1	2018-01-06 00:00:00	9192	9180	12	32	32686	5
65	1	1	2018-01-06 01:00:00	9974	9774	200	38	724	5
66	1	1	2018-01-06 02:00:00	9795	9774	21	37	628	5
67	1	1	2018-01-06 03:00:00	9199	9126	73	27	398	5
68	1	1	2018-01-06 04:00:00	8941	8802	139	49	428	5
69	1	1	2018-01-06 05:00:00	9019	9018	1	45	630	5
70	1	1	2018-01-06 06:00:00	9779	9612	167	49	710	10
71	1	1	2018-01-06 07:00:00	8950	9018	-68	32	648	5
72	1	1	2018-01-06 08:00:00	8556	8424	132	44	666	5
73	1	1	2018-01-06 09:00:00	8040	7938	102	33	834	5
74	1	1	2018-01-06 10:00:00	7520	7560	-40	20	1176	5
75	1	1	2018-01-06 11:00:00	9672	9450	222	59	1018	5
76	1	1	2018-01-06 12:00:00	8204	8316	-112	42	444	5
77	1	1	2018-01-06 13:00:00	10436	10260	176	37	906	5
78	1	1	2018-01-06 14:00:00	8767	8640	127	46	264	10
79	1	1	2018-01-06 15:00:00	5945	5886	59	36	990	11
80	1	1	2018-01-06 16:00:00	8596	8532	64	20	58206	4
81	1	1	2018-01-06 17:00:00	7914	7938	-24	31	1658	4
82	1	1	2018-01-06 18:00:00	7455	7344	111	18	654	4
83	1	1	2018-01-06 19:00:00	6120	6156	-36	39	1266	4
84	1	1	2018-01-06 20:00:00	9028	8910	118	37	1032	4
85	1	1	2018-01-06 21:00:00	3063	3186	-123	32	1566	4
86	1	1	2018-01-06 22:00:00	9095	8856	239	50	744	8
87	1	1	2018-01-06 23:00:00	10060	9936	124	29	2502	8
88	1	1	2018-01-07 00:00:00	5024	5508	-484	40	660	4
89	1	1	2018-01-07 01:00:00	6966	6318	648	31	360	4
90	1	1	2018-01-07 02:00:00	8999	8964	35	32	2726	4
91	1	1	2018-01-07 03:00:00	9440	9288	152	34	586	4
92	1	1	2018-01-07 04:00:00	8060	7884	176	49	640	4
93	1	1	2018-01-07 05:00:00	8403	8316	87	52	660	4
94	1	1	2018-01-07 06:00:00	7828	7830	-2	41	894	8
95	1	1	2018-01-07 07:00:00	7900	7722	178	94	1038	9
96	1	1	2018-01-07 08:00:00	9108	9018	90	94	966	6
97	1	1	2018-01-07 09:00:00	8727	8694	33	89	588	6
98	1	1	2018-01-07 10:00:00	8742	8748	-6	118	716	6
99	1	1	2018-01-07 11:00:00	10184	10044	140	116	696	6
100	1	1	2018-01-07 12:00:00	9712	9666	46	32	290	6
101	1	1	2018-01-07 13:00:00	9588	9558	30	20	594	6
102	1	1	2018-01-07 14:00:00	10312	10206	106	28	364	12
103	1	1	2018-01-07 15:00:00	6880	6804	76	49	236	20
104	1	1	2018-01-07 16:00:00	9551	9558	-7	48	1356	4
105	1	1	2018-01-07 17:00:00	9368	9234	134	59	516	4
106	1	1	2018-01-07 18:00:00	7688	7722	-34	42	514	4
107	1	1	2018-01-07 19:00:00	5100	5022	78	49	2988	4
108	1	1	2018-01-07 20:00:00	5479	5400	79	26	368	4
109	1	1	2018-01-07 21:00:00	7595	7614	-19	45	1794	4
110	1	1	2018-01-07 22:00:00	6925	6804	121	59	1126	8
111	1	1	2018-01-07 23:00:00	8088	8208	-120	81	1272	8
112	1	1	2018-01-08 00:00:00	5546	5868	-322	42	1050	4
113	1	3	2018-01-08 01:00:00	5506	4860	646	37	3212	4
114	1	3	2018-01-08 02:00:00	9363	9288	75	28	294	4
115	1	3	2018-01-08 03:00:00	8624	8424	200	49	522	4
116	1	3	2018-01-08 04:00:00	8634	8478	156	68	834	4
117	1	3	2018-01-08 05:00:00	6382	6426	-44	58	802	4
118	1	3	2018-01-08 06:00:00	6784	6588	196	88	1576	13
119	1	3	2018-01-08 07:00:00	8804	8640	164	36	1258	8
120	1	3	2018-01-08 08:00:00	9324	9180	144	51	718	8
121	1	3	2018-01-08 09:00:00	8920	8910	10	62	556	8
122	1	3	2018-01-08 10:00:00	9176	8964	212	123	618	8
123	1	3	2018-01-08 11:00:00	9388	9288	100	102	648	8
124	1	3	2018-01-08 12:00:00	6698	6642	56	71	454	8
125	1	3	2018-01-08 13:00:00	10095	10044	51	54	1402	8
126	1	3	2018-01-08 14:00:00	8943	8802	141	62	324	16
127	1	3	2018-01-08 15:00:00	9863	9720	143	53	674	20
128	1	3	2018-01-08 16:00:00	7490	7974	-484	56	416	4
129	1	1	2018-01-08 18:00:00	5087	4698	389	11	578	4
130	1	1	2018-01-08 19:00:00	9530	9450	80	32	400	4
131	1	1	2018-01-08 20:00:00	9436	9288	148	48	756	4
132	1	1	2018-01-08 21:00:00	10376	10260	116	49	722	4
133	1	1	2018-01-08 22:00:00	10096	10044	52	41	2078	8
134	1	1	2018-01-08 23:00:00	8564	8586	-22	62	636	8
135	1	1	2018-01-09 00:00:00	9801	9720	81	28	256	4
136	1	1	2018-01-09 01:00:00	8720	8586	134	44	222	4
137	1	1	2018-01-09 02:00:00	9963	9882	81	30	238	4
138	1	1	2018-01-09 03:00:00	8088	7938	150	35	508	4
139	1	1	2018-01-09 04:00:00	8072	8046	26	37	1864	4
140	1	1	2018-01-09 05:00:00	7340	7290	50	26	542	4
141	1	1	2018-01-09 06:00:00	9199	9126	73	22	610	8
142	1	1	2018-01-09 07:00:00	8916	8910	6	24	1490	4
143	1	1	2018-01-09 08:00:00	8936	8856	80	46	514	4
144	1	1	2018-01-09 09:00:00	7980	7830	150	42	480	4
145	1	1	2018-01-09 10:00:00	4476	4482	-6	25	1112	4
146	1	1	2018-01-09 11:00:00	9792	9666	126	37	886	4
147	1	1	2018-01-09 12:00:00	5893	6372	-479	33	188	4
148	1	1	2018-01-09 13:00:00	5113	4644	469	35	176	4
149	1	1	2018-01-09 14:00:00	10143	9990	153	46	570	8
150	1	1	2018-01-09 15:00:00	9276	9234	42	47	716	8
151	1	1	2018-01-09 16:00:00	9684	9612	72	28	274	7
152	1	1	2018-01-09 17:00:00	8366	8316	50	87	858	3
153	1	1	2018-01-09 18:00:00	9112	9018	94	39	1036	3
154	1	1	2018-01-09 19:00:00	8578	8586	-8	51	640	3
155	1	1	2018-01-09 20:00:00	8399	8316	83	28	4806	3
156	1	1	2018-01-09 21:00:00	9132	9072	60	33	868	3
157	1	1	2018-01-09 22:00:00	9376	9342	34	68	502	6
158	1	1	2018-01-09 23:00:00	8824	8694	130	43	594	6
159	1	1	2018-01-10 00:00:00	8868	8856	12	48	616	3
160	1	1	2018-01-10 01:00:00	8956	8892	64	38	904	3
161	1	1	2018-01-10 02:00:00	9924	9882	42	46	916	3
162	1	1	2018-01-10 03:00:00	9448	9342	106	47	484	3
163	1	1	2018-01-10 04:00:00	9196	9180	16	39	332	3
164	1	1	2018-01-10 05:00:00	6211	6102	109	62	972	3
165	1	1	2018-01-10 06:00:00	8980	9018	-38	38	556	6
166	1	1	2018-01-10 07:00:00	8812	8748	64	39	492	3
167	1	1	2018-01-10 08:00:00	8340	8262	78	37	698	3
168	1	1	2018-01-10 09:00:00	8584	8532	52	75	1316	4
169	1	1	2018-01-10 10:00:00	7650	7560	90	43	890	4
170	1	1	2018-01-10 11:00:00	7092	7236	-144	34	286	4
171	1	1	2018-01-10 12:00:00	9003	8694	309	39	1288	4
172	1	1	2018-01-10 13:00:00	8700	8694	6	36	670	4
173	1	1	2018-01-10 14:00:00	9520	9396	124	40	342	8
174	1	1	2018-01-10 15:00:00	7669	7668	1	94	436	8
175	1	1	2018-01-10 16:00:00	6993	6912	81	43	2182	4
176	1	1	2018-01-10 17:00:00	4572	4644	-72	49	622	4
177	1	1	2018-01-10 18:00:00	7919	7830	89	93	748	4
178	1	1	2018-01-10 19:00:00	7561	7506	55	33	420	4
179	1	1	2018-01-10 20:00:00	4312	4374	-62	33	206	4
180	1	1	2018-01-10 21:00:00	620	486	134	79	464	4
181	1	1	2018-01-10 22:00:00	8936	8856	80	33	520	8
182	1	1	2018-01-10 23:00:00	9676	9720	-44	41	526	8
183	1	1	2018-01-11 00:00:00	4690	5148	-458	44	212	4
184	1	1	2018-01-11 01:00:00	5394	4860	534	70	446	4
185	1	1	2018-01-11 02:00:00	9056	9018	38	104	1028	4
186	1	1	2018-01-11 03:00:00	9363	9234	129	62	424	4
187	1	1	2018-01-11 04:00:00	9256	9180	76	44	256	8
188	1	1	2018-01-11 05:00:00	4466	4428	38	62	408	4
189	1	1	2018-01-11 06:00:00	7256	7236	20	51	604	8
190	1	1	2018-01-11 07:00:00	4232	4212	20	131	406	7
191	1	1	2018-01-11 08:00:00	4984	4914	70	84	3452	3
192	1	1	2018-01-11 09:00:00	3378	3294	84	1	2050	3
193	1	1	2018-01-11 10:00:00	6012	5994	18	29	680	3
194	1	1	2018-01-11 11:00:00	3996	3942	54	36	316	3
195	1	1	2018-01-11 12:00:00	4364	4320	44	49	638	3
196	1	1	2018-01-11 13:00:00	6609	6588	21	24	4770	3
197	1	1	2018-01-11 14:00:00	7660	7560	100	4	14	6
198	1	1	2018-01-11 15:00:00	9516	9504	12	30	412	11
199	1	1	2018-01-11 16:00:00	5040	5022	18	29	270	8
200	1	1	2018-01-11 17:00:00	5424	5346	78	62	536	8
201	1	1	2018-01-11 18:00:00	5935	5886	49	54	964	8
202	1	1	2018-01-11 19:00:00	5551	5562	-11	33	442	8
203	1	1	2018-01-11 20:00:00	164	108	56	39	568	8
204	1	1	2018-01-11 21:00:00	9044	8964	80	40	1062	8
205	1	1	2018-01-11 22:00:00	9266	9234	32	30	774	16
206	1	1	2018-01-11 23:00:00	7352	7398	-46	50	670	16
207	1	1	2018-01-12 00:00:00	8236	8046	190	33	1326	8
208	1	1	2018-01-12 01:00:00	6624	6534	90	103	1910	8
209	1	1	2018-01-12 02:00:00	7339	7236	103	39	1514	8
210	1	1	2018-01-12 03:00:00	8431	8424	7	27	492	8
211	1	1	2018-01-12 04:00:00	5096	5076	20	29	290	8
212	1	1	2018-01-12 05:00:00	7732	7614	118	67	498	8
213	1	1	2018-01-12 06:00:00	7887	7830	57	34	280	16
214	1	1	2018-01-12 07:00:00	5692	5670	22	43	258	8
215	1	1	2018-01-12 08:00:00	8980	8910	70	31	288	8
216	1	1	2018-01-12 09:00:00	9482	9396	86	69	372	8
217	1	1	2018-01-12 10:00:00	4556	4536	20	53	638	8
218	1	1	2018-01-12 11:00:00	2968	2916	52	7	3398	8
219	1	1	2018-01-12 14:00:00	0	108	-108	11	17876	16
220	1	1	2018-01-12 19:00:00	7096	6912	184	29	308	8
221	1	1	2018-01-12 20:00:00	8186	8154	32	43	392	8
222	1	1	2018-01-12 21:00:00	8232	8100	132	19	1496	8
223	1	1	2018-01-12 22:00:00	8319	8208	111	79	848	16
224	1	1	2018-01-12 23:00:00	8971	9018	-47	84	866	16
225	1	1	2018-01-13 00:00:00	8992	8856	136	3	26658	8
226	1	1	2018-01-13 01:00:00	9460	9396	64	50	648	8
227	1	1	2018-01-13 02:00:00	4716	5184	-468	48	698	8
228	1	1	2018-01-13 03:00:00	6948	6372	576	38	536	8
229	1	1	2018-01-13 04:00:00	9418	9342	76	32	2940	8
230	1	1	2018-01-13 05:00:00	8363	8262	101	29	406	8
231	1	1	2018-01-13 06:00:00	7852	7938	-86	61	542	16
232	1	1	2018-01-13 07:00:00	6852	6588	264	53	882	8
233	1	1	2018-01-13 08:00:00	7004	6966	38	1	34200	8
234	1	1	2018-01-13 09:00:00	9492	9396	96	71	1090	8
235	1	1	2018-01-13 10:00:00	9928	9882	46	58	1404	8
236	1	1	2018-01-13 11:00:00	8675	8586	89	84	1208	8
237	1	1	2018-01-13 12:00:00	9670	9558	112	60	472	8
238	1	1	2018-01-13 13:00:00	9196	9126	70	41	556	8
239	1	1	2018-01-13 14:00:00	9199	9072	127	54	578	16
240	1	1	2018-01-13 15:00:00	9808	9828	-20	48	456	16
241	1	1	2018-01-13 16:00:00	10256	10098	158	52	620	8
242	1	1	2018-01-13 17:00:00	10160	10098	62	48	626	8
243	1	1	2018-01-13 18:00:00	9832	9828	4	29	390	8
244	1	1	2018-01-13 19:00:00	10080	9936	144	1	61058	8
245	1	1	2018-01-13 20:00:00	9980	9990	-10	43	290	8
246	1	1	2018-01-13 21:00:00	10025	9882	143	48	292	8
247	1	1	2018-01-13 22:00:00	9955	9990	-35	43	414	16
248	1	1	2018-01-13 23:00:00	9876	9720	156	34	332	16
249	1	1	2018-01-14 00:00:00	9654	9612	42	28	382	8
250	1	1	2018-01-14 01:00:00	9976	9882	94	35	354	8
251	1	1	2018-01-14 02:00:00	8664	8532	132	35	412	8
252	1	1	2018-01-14 03:00:00	9624	9612	12	46	404	8
253	1	1	2018-01-14 04:00:00	9396	9342	54	50	434	8
254	1	1	2018-01-14 05:00:00	9744	9720	24	46	424	8
255	1	1	2018-01-14 06:00:00	10404	10260	144	46	748	16
256	1	1	2018-01-14 07:00:00	9883	9828	55	34	446	8
257	1	1	2018-01-14 08:00:00	9369	9342	27	36	424	8
258	1	1	2018-01-14 09:00:00	8251	8208	43	27	406	8
259	1	1	2018-01-14 10:00:00	8191	8100	91	56	532	8
260	1	1	2018-01-14 11:00:00	4508	4950	-442	87	936	8
261	1	5	2018-01-14 12:00:00	2218	1620	598	49	874	8
262	1	5	2018-01-14 13:00:00	9456	9342	114	65	5004	8
263	1	5	2018-01-14 14:00:00	9551	9396	155	5	58	16
264	1	5	2018-01-14 15:00:00	10496	10368	128	73	512	16
265	1	5	2018-01-14 16:00:00	9776	9666	110	69	470	8
266	1	5	2018-01-14 17:00:00	9542	9558	-16	62	152	8
267	1	5	2018-01-14 18:00:00	10203	10044	159	49	414	8
268	1	5	2018-01-14 19:00:00	10394	10368	26	58	454	8
269	1	5	2018-01-14 20:00:00	9546	9504	42	46	304	8
270	1	5	2018-01-14 21:00:00	9223	8946	277	52	170	8
271	1	5	2018-01-14 22:00:00	9325	9558	-233	68	620	16
272	1	5	2018-01-14 23:00:00	2330	1926	404	69	438	17
273	1	5	2018-01-14 23:00:00	2330	1926	404	69	438	17
274	1	5	2018-01-15 00:00:00	9244	9180	64	53	538	4
275	1	5	2018-01-15 01:00:00	9628	9774	-146	19	2878	4
276	1	5	2018-01-15 02:00:00	5719	5562	157	47	566	4
277	1	5	2018-01-15 03:00:00	9380	9234	146	50	582	4
278	1	5	2018-01-15 04:00:00	9087	9018	69	55	1620	4
279	1	5	2018-01-15 05:00:00	9123	9126	-3	88	554	4
280	1	5	2018-01-15 06:00:00	9440	9396	44	40	640	8
281	1	5	2018-01-15 07:00:00	9595	9450	145	32	628	4
282	1	5	2018-01-15 08:00:00	9953	9882	71	28	546	4
283	1	5	2018-01-15 09:00:00	9227	9234	-7	45	504	4
284	1	5	2018-01-15 10:00:00	10164	10044	120	38	452	4
285	1	5	2018-01-15 11:00:00	10351	10260	91	42	510	4
286	1	5	2018-01-15 12:00:00	9408	9450	-42	89	326	4
287	1	5	2018-01-15 13:00:00	10648	10530	118	28	274	4
288	1	5	2018-01-15 14:00:00	10347	10314	33	52	488	8
289	1	5	2018-01-15 15:00:00	10884	10800	84	29	190	8
290	1	5	2018-01-15 16:00:00	9900	9882	18	20	262	4
291	1	5	2018-01-15 17:00:00	10164	10098	66	10	86	4
292	1	5	2018-01-15 18:00:00	9392	9342	50	43	396	4
293	1	5	2018-01-15 19:00:00	9192	9180	12	33	314	4
294	1	5	2018-01-15 20:00:00	3583	3564	19	53	550	4
295	1	5	2018-01-15 21:00:00	4523	4482	41	81	586	4
296	1	5	2018-01-15 22:00:00	6076	6048	28	20	3498	8
297	1	5	2018-01-15 23:00:00	7572	7506	66	40	1310	8
298	1	5	2018-01-16 00:00:00	9083	9072	11	39	2040	4
299	1	5	2018-01-16 01:00:00	9027	9072	-45	47	528	4
300	1	5	2018-01-16 02:00:00	8856	8748	108	48	626	4
301	1	5	2018-01-16 03:00:00	8484	8424	60	59	656	4
302	1	5	2018-01-16 04:00:00	9487	9558	-71	47	730	4
303	1	5	2018-01-16 05:00:00	8015	7830	185	57	856	4
304	1	5	2018-01-16 06:00:00	8657	8640	17	66	630	8
305	1	5	2018-01-16 07:00:00	8723	8694	29	98	1056	4
306	1	5	2018-01-16 08:00:00	9635	9558	77	80	596	4
307	1	5	2018-01-16 09:00:00	2480	2430	50	77	740	4
308	1	5	2018-01-16 10:00:00	10507	10476	31	85	1322	4
309	1	5	2018-01-16 11:00:00	9916	9882	34	24	1990	4
310	1	5	2018-01-16 12:00:00	2691	3168	-477	46	126	4
311	1	6	2018-01-16 13:00:00	1690	1080	610	67	512	4
312	1	6	2018-01-16 14:00:00	5680	5454	226	29	4260	8
313	1	6	2018-01-16 15:00:00	4664	4482	182	22	1400	8
314	1	6	2018-01-16 16:00:00	1670	2196	-526	34	1586	4
315	1	1	2018-01-16 17:00:00	2350	1782	568	31	2086	4
316	1	1	2018-01-16 18:00:00	3940	3996	-56	78	5578	4
317	1	1	2018-01-16 19:00:00	9194	9072	122	24	114	4
318	1	1	2018-01-16 20:00:00	4078	3942	136	59	2278	4
319	1	1	2018-01-16 21:00:00	9472	9396	76	81	630	4
320	1	1	2018-01-16 22:00:00	8605	8532	73	71	2272	8
321	1	1	2018-01-16 23:00:00	7039	7236	-197	61	472	8
322	1	1	2018-01-17 00:00:00	7809	7506	303	70	904	4
323	1	1	2018-01-17 01:00:00	7554	7560	-6	60	1192	4
324	1	1	2018-01-17 02:00:00	7187	7074	113	87	1026	4
325	1	1	2018-01-17 07:00:00	5012	5022	-10	21	208	4
326	1	1	2018-01-17 08:00:00	9192	9126	66	60	16610	4
327	1	1	2018-01-17 09:00:00	9392	9288	104	16	142	4
328	1	1	2018-01-17 10:00:00	9258	9180	78	35	366	4
329	1	1	2018-01-17 11:00:00	9454	9450	4	28	188	4
330	1	1	2018-01-17 12:00:00	8510	8532	-22	28	238	4
331	1	1	2018-01-17 13:00:00	9832	9720	112	47	440	4
332	1	1	2018-01-17 14:00:00	8339	8208	131	22	170	8
333	1	1	2018-01-17 15:00:00	7788	7938	-150	25	288	8
334	1	1	2018-01-17 16:00:00	8330	8154	176	17	222	4
335	1	1	2018-01-17 17:00:00	9683	9558	125	25	1402	4
336	1	1	2018-01-17 18:00:00	10022	9936	86	26	414	4
337	1	1	2018-01-17 19:00:00	8372	8316	56	35	350	4
338	1	1	2018-01-17 20:00:00	8631	8532	99	28	242	4
339	1	1	2018-01-17 21:00:00	9556	9720	-164	28	538	4
340	1	1	2018-01-17 22:00:00	9708	9450	258	25	1476	8
341	1	1	2018-01-17 23:00:00	1280	1134	146	23	272	8
342	1	1	2018-01-18 00:00:00	924	1080	-156	70	5908	3
343	1	1	2018-01-18 01:00:00	8939	9018	-79	8	2224	4
344	1	1	2018-01-18 02:00:00	6544	6372	172	75	678	4
345	1	1	2018-01-18 03:00:00	8520	8478	42	99	1726	4
346	1	1	2018-01-18 04:00:00	4807	4752	55	62	512	4
347	1	1	2018-01-18 05:00:00	9188	9180	8	46	2088	4
348	1	1	2018-01-18 06:00:00	7111	7020	91	98	496	8
349	1	1	2018-01-18 07:00:00	9071	8910	161	95	1260	4
350	1	1	2018-01-18 08:00:00	9560	9450	110	28	31068	4
351	1	1	2018-01-18 09:00:00	9171	9018	153	44	614	4
352	1	1	2018-01-18 10:00:00	4164	4608	-444	50	508	4
353	1	1	2018-01-18 14:00:00	1826	1242	584	30	3810	8
354	1	1	2018-01-18 15:00:00	8543	8262	281	2	1902	8
355	1	1	2018-01-18 16:00:00	8831	8802	29	7	2978	4
356	1	1	2018-01-18 17:00:00	9962	9774	188	58	854	4
357	1	1	2018-01-18 18:00:00	9216	9180	36	38	260	4
358	1	1	2018-01-18 19:00:00	9727	9558	169	29	288	4
359	1	1	2018-01-18 20:00:00	8586	8532	54	30	1392	4
360	1	1	2018-01-18 21:00:00	9582	9450	132	36	590	4
361	1	1	2018-01-18 22:00:00	9289	9072	217	26	276	8
362	1	1	2018-01-18 23:00:00	8726	8856	-130	37	284	12
363	1	1	2018-01-19 00:00:00	9471	9234	237	45	460	4
364	1	1	2018-01-19 01:00:00	10387	10260	127	35	286	4
365	1	1	2018-01-19 02:00:00	6396	6858	-462	45	356	4
366	1	1	2018-01-19 03:00:00	5239	4644	595	48	932	4
367	1	1	2018-01-19 04:00:00	9450	9288	162	63	902	4
368	1	1	2018-01-19 05:00:00	9243	9180	63	36	312	4
369	1	1	2018-01-19 06:00:00	7880	7938	-58	22	136	8
370	1	1	2018-01-19 07:00:00	7138	7074	64	41	326	4
371	1	1	2018-01-19 08:00:00	6718	6426	292	24	2702	4
372	1	1	2018-01-19 09:00:00	8819	8856	-37	9	1476	4
373	1	1	2018-01-19 10:00:00	10480	10314	166	63	328	4
374	1	1	2018-01-19 11:00:00	10044	9936	108	26	248	4
375	1	1	2018-01-19 12:00:00	7707	7614	93	35	298	4
376	1	1	2018-01-19 13:00:00	6419	6318	101	21	800	4
377	1	1	2018-01-19 14:00:00	7240	7128	112	31	380	8
378	1	1	2018-01-19 15:00:00	9806	9774	32	18	184	8
379	1	1	2018-01-19 16:00:00	8260	8154	106	37	632	4
380	1	1	2018-01-19 17:00:00	8636	8694	-58	37	204	4
381	1	1	2018-01-19 18:00:00	8108	7938	170	42	344	4
382	1	1	2018-01-19 19:00:00	8059	8046	13	42	488	4
383	1	1	2018-01-19 20:00:00	10016	9828	188	41	608	4
384	1	1	2018-01-19 21:00:00	1286	1350	-64	34	868	4
385	1	1	2018-01-19 22:00:00	6667	6750	-83	26	3638	8
386	1	1	2018-01-20 06:00:00	680	486	194	26	256	8
387	1	1	2018-01-20 07:00:00	6944	6912	32	39	346	4
388	1	1	2018-01-20 08:00:00	8992	8910	82	34	476	4
389	1	1	2018-01-20 09:00:00	9608	9612	-4	67	922	4
390	1	1	2018-01-20 10:00:00	9348	9234	114	43	490	4
391	1	1	2018-01-20 11:00:00	7512	7398	114	34	232	4
392	1	1	2018-01-20 12:00:00	8806	8694	112	49	552	4
393	1	1	2018-01-20 13:00:00	8579	8532	47	38	256	4
394	1	1	2018-01-20 14:00:00	7367	7848	-481	41	546	8
395	1	1	2018-01-21 06:00:00	1958	1296	662	40	618	8
396	1	1	2018-01-21 07:00:00	4321	4320	1	38	296	4
397	1	1	2018-01-21 08:00:00	8972	8910	62	37	360	4
398	1	1	2018-01-21 09:00:00	8658	8586	72	67	476	4
399	1	1	2018-01-21 10:00:00	9301	9234	67	50	364	4
400	1	1	2018-01-21 11:00:00	8820	8748	72	57	522	4
401	1	1	2018-01-21 12:00:00	7308	7236	72	34	274	4
402	1	1	2018-01-21 13:00:00	8336	8262	74	25	224	4
403	1	1	2018-01-21 14:00:00	3058	3564	-506	32	438	8
404	1	7	2018-01-21 15:00:00	710	108	602	26	268	8
405	1	7	2018-01-21 16:00:00	7903	7884	19	57	788	4
406	1	7	2018-01-21 17:00:00	9696	9828	-132	36	814	4
407	1	7	2018-01-21 18:00:00	10460	10206	254	70	1176	4
408	1	7	2018-01-21 19:00:00	8981	8910	71	68	612	4
409	1	7	2018-01-21 20:00:00	9579	9558	21	32	3984	4
410	1	7	2018-01-21 21:00:00	7802	7776	26	50	584	4
411	1	7	2018-01-21 22:00:00	8940	8802	138	51	396	13
412	1	7	2018-01-21 23:00:00	9735	9720	15	26	510	5
413	1	7	2018-01-22 00:00:00	9687	9666	21	46	552	5
414	1	7	2018-01-22 01:00:00	10080	9936	144	22	656	5
415	1	7	2018-01-22 02:00:00	9850	9774	76	28	196	5
416	1	7	2018-01-22 03:00:00	10860	10854	6	24	98	5
417	1	7	2018-01-22 04:00:00	10387	10314	73	20	100	5
418	1	7	2018-01-22 05:00:00	9472	9450	22	33	456	5
419	1	7	2018-01-22 06:00:00	7541	7506	35	38	298	10
420	1	7	2018-01-22 07:00:00	8884	8802	82	48	392	5
421	1	7	2018-01-22 08:00:00	10339	10260	79	48	1266	5
422	1	7	2018-01-22 09:00:00	6091	6048	43	32	360	5
423	1	7	2018-01-22 10:00:00	8579	8640	-61	39	578	5
424	1	7	2018-01-22 11:00:00	9106	8964	142	42	408	5
425	1	7	2018-01-22 12:00:00	3313	3294	19	41	458	5
426	1	7	2018-01-22 13:00:00	8931	8856	75	36	530	5
427	1	7	2018-01-22 14:00:00	9140	9072	68	38	494	10
428	1	7	2018-01-22 15:00:00	9892	9774	118	65	764	18
429	1	7	2018-01-22 16:00:00	6486	7038	-552	31	562	8
430	1	7	2018-01-22 18:00:00	9440	9072	368	61	764	3
431	1	7	2018-01-22 19:00:00	10560	10368	192	40	416	3
432	1	7	2018-01-22 20:00:00	10412	10368	44	25	160	3
433	1	7	2018-01-22 21:00:00	9668	9666	2	22	9008	3
434	1	7	2018-01-22 22:00:00	6852	6804	48	43	480	16
435	1	7	2018-01-22 23:00:00	10580	10530	50	55	1346	16
436	1	7	2018-01-23 00:00:00	1900	1890	10	50	158	8
437	1	7	2018-01-23 01:00:00	5024	4860	164	6	3376	8
438	1	7	2018-01-23 02:00:00	8816	8910	-94	52	1634	8
439	1	7	2018-01-23 03:00:00	9524	9504	20	88	680	8
440	1	7	2018-01-23 04:00:00	10164	9990	174	89	460	8
441	1	7	2018-01-23 05:00:00	9176	9180	-4	67	410	8
442	1	7	2018-01-23 06:00:00	9180	9180	0	64	466	16
443	1	7	2018-01-23 07:00:00	1100	1296	-196	163	586	8
444	1	7	2018-01-23 10:00:00	108	0	108	1	17102	8
445	1	7	2018-01-23 12:00:00	16	0	16	39	3124	8
446	1	7	2018-01-23 13:00:00	584	702	-118	46	640	8
447	1	7	2018-01-23 14:00:00	8	0	8	42	488	16
448	1	7	2018-01-23 15:00:00	32	0	32	34	410	16
449	1	7	2018-01-23 16:00:00	12	0	12	29	948	8
450	1	7	2018-01-23 17:00:00	36	0	36	14	3914	8
451	1	7	2018-01-23 18:00:00	248	216	32	27	1506	8
452	1	7	2018-01-23 19:00:00	260	216	44	131	1292	8
453	1	7	2018-01-23 20:00:00	6232	5994	238	122	840	8
454	1	7	2018-01-23 21:00:00	8360	8424	-64	123	954	8
455	1	7	2018-01-23 22:00:00	8090	8100	-10	58	830	21
456	1	7	2018-01-23 23:00:00	8695	8586	109	63	862	5
457	1	7	2018-01-24 00:00:00	8051	7884	167	67	516	5
458	1	7	2018-01-24 01:00:00	9432	9396	36	58	146	5
459	1	7	2018-01-24 02:00:00	10516	10476	40	87	596	5
460	1	7	2018-01-24 03:00:00	9152	9072	80	54	348	5
461	1	7	2018-01-24 04:00:00	10046	9990	56	39	422	5
462	1	7	2018-01-24 05:00:00	9668	9612	56	50	356	5
463	1	7	2018-01-24 06:00:00	9928	9828	100	102	2416	13
464	1	7	2018-01-24 07:00:00	9004	8964	40	30	764	8
465	1	7	2018-01-24 08:00:00	3243	3132	111	42	434	8
466	1	7	2018-01-24 09:00:00	9744	9666	78	108	708	8
467	1	7	2018-01-24 10:00:00	8756	8802	-46	83	686	8
468	1	7	2018-01-24 11:00:00	8948	8748	200	22	462	8
469	1	7	2018-01-24 12:00:00	6956	6912	44	32	3874	8
470	1	7	2018-01-24 13:00:00	7669	8136	-467	51	306	8
471	1	8	2018-01-24 14:00:00	2471	1944	527	21	300	16
472	1	8	2018-01-24 15:00:00	9341	9072	269	32	308	8
473	1	8	2018-01-24 16:00:00	8356	8370	-14	54	660	4
474	1	8	2018-01-24 17:00:00	10216	9990	226	29	230	4
475	1	8	2018-01-24 18:00:00	8281	8640	-359	30	3074	4
476	1	8	2018-01-24 19:00:00	0	18	-18	18	6034	4
477	1	1	2018-01-24 20:00:00	6142	5906	236	2	1334	4
478	1	1	2018-01-24 21:00:00	9808	10302	-494	2	5962	4
479	1	1	2018-01-24 22:00:00	9672	10082	-410	50	470	8
480	1	1	2018-01-24 23:00:00	9744	10176	-432	46	442	8
481	1	1	2018-01-25 00:00:00	9754	10302	-548	56	338	4
482	1	1	2018-01-25 01:00:00	9568	10046	-478	40	1690	4
483	1	1	2018-01-25 02:00:00	10076	10576	-500	40	446	4
484	1	1	2018-01-25 03:00:00	6867	7446	-579	45	468	4
485	1	1	2018-01-25 04:00:00	8736	8963	-227	82	540	4
486	1	1	2018-01-25 05:00:00	9648	9921	-273	72	1240	4
487	1	1	2018-01-25 06:00:00	9360	10022	-662	46	530	8
488	1	1	2018-01-25 07:00:00	7199	7762	-563	54	708	4
489	1	1	2018-01-25 08:00:00	9317	9920	-603	94	402	4
490	1	1	2018-01-25 09:00:00	8794	9614	-820	79	450	4
491	1	1	2018-01-25 10:00:00	9814	10516	-702	111	1000	4
492	1	1	2018-01-25 11:00:00	9824	10382	-558	44	1060	4
493	1	1	2018-01-25 12:00:00	7892	8700	-808	78	1010	4
494	1	1	2018-01-25 13:00:00	8032	8646	-614	83	308	4
495	1	1	2018-01-25 14:00:00	7512	8274	-762	102	906	10
496	1	1	2018-01-25 15:00:00	10124	10788	-664	91	682	6
497	1	1	2018-01-25 16:00:00	8939	9880	-941	40	410	3
498	1	1	2018-01-25 17:00:00	8098	8856	-758	47	546	3
499	1	1	2018-01-25 18:00:00	9920	10518	-598	48	372	3
500	1	1	2018-01-25 19:00:00	9292	9998	-706	49	506	3
501	1	1	2018-01-25 20:00:00	9888	10394	-506	58	598	3
502	1	1	2018-01-25 21:00:00	9786	10344	-558	31	336	3
503	1	1	2018-01-25 22:00:00	9051	9660	-609	37	906	6
504	1	1	2018-01-25 23:00:00	10066	10546	-480	41	640	6
505	1	1	2018-01-26 00:00:00	8236	8718	-482	53	980	3
506	1	1	2018-01-26 01:00:00	9388	10022	-634	29	14748	3
507	1	1	2018-01-26 02:00:00	7907	8538	-631	21	668	3
508	1	1	2018-01-26 03:00:00	1708	1938	-230	48	884	3
509	1	1	2018-01-26 07:00:00	6416	6591	-175	100	954	3
510	1	1	2018-01-26 08:00:00	8416	8562	-146	53	716	3
511	1	1	2018-01-26 09:00:00	8132	8162	-30	56	1118	3
512	1	1	2018-01-26 10:00:00	9032	9110	-78	50	532	3
513	1	1	2018-01-26 11:00:00	7368	7539	-171	55	722	3
514	1	1	2018-01-26 12:00:00	9391	9432	-41	103	448	3
515	1	1	2018-01-26 13:00:00	8808	8914	-106	79	570	3
516	1	1	2018-01-26 14:00:00	9604	9740	-136	28	222	6
517	1	1	2018-01-26 15:00:00	9275	9395	-120	93	580	6
518	1	1	2018-01-26 16:00:00	10444	10479	-35	77	600	3
519	1	1	2018-01-26 17:00:00	9332	9464	-132	18	534	3
520	1	1	2018-01-26 18:00:00	9172	9199	-27	45	648	3
521	1	1	2018-01-26 19:00:00	9547	9600	-53	49	460	3
522	1	1	2018-01-26 20:00:00	8960	9095	-135	47	416	3
523	1	1	2018-01-26 21:00:00	9628	9665	-37	54	844	3
524	1	1	2018-01-26 22:00:00	9836	9980	-144	104	1734	6
525	1	1	2018-01-26 23:00:00	9344	9412	-68	64	1620	6
526	1	1	2018-01-27 00:00:00	8196	8335	-139	109	1322	3
527	1	1	2018-01-27 01:00:00	7788	7895	-107	80	776	3
528	1	1	2018-01-27 02:00:00	5609	5796	-187	53	626	3
529	1	1	2018-01-27 03:00:00	5980	6091	-111	31	412	3
530	1	1	2018-01-27 04:00:00	7291	7450	-159	27	330	3
531	1	1	2018-01-27 05:00:00	8075	8315	-240	51	540	3
532	1	1	2018-01-27 06:00:00	9196	9165	31	75	696	6
533	1	1	2018-01-27 07:00:00	9896	9960	-64	46	334	7
534	1	1	2018-01-27 08:00:00	9424	9494	-70	112	4180	4
535	1	1	2018-01-27 09:00:00	9984	10125	-141	7	384	4
536	1	1	2018-01-27 10:00:00	7572	7632	-60	59	1252	4
537	1	1	2018-01-27 11:00:00	468	584	-116	41	716	4
538	1	1	2018-01-27 12:00:00	7415	7652	-237	34	29322	4
539	1	1	2018-01-27 13:00:00	8632	8589	43	3	78	4
540	1	1	2018-01-27 14:00:00	6876	6707	169	66	976	8
541	1	1	2018-01-27 22:00:00	1824	1572	252	17	2776	8
542	1	1	2018-01-27 23:00:00	8908	8875	33	51	838	8
543	1	1	2018-01-28 00:00:00	8204	8233	-29	47	834	4
544	1	1	2018-01-28 01:00:00	9108	9138	-30	60	384	4
545	1	1	2018-01-28 02:00:00	2628	2979	-351	66	912	4
546	1	1	2018-01-28 03:00:00	7971	7668	303	1	2326	4
547	1	1	2018-01-28 04:00:00	8884	8802	82	46	372	4
548	1	1	2018-01-28 05:00:00	9563	9504	59	28	1558	4
549	1	1	2018-01-28 06:00:00	8349	8190	159	38	326	8
550	1	1	2018-01-28 07:00:00	9872	9882	-10	44	1360	4
551	1	1	2018-01-28 08:00:00	10092	10044	48	34	892	4
552	1	1	2018-01-28 09:00:00	10036	9990	46	40	940	4
553	1	1	2018-01-28 10:00:00	9896	10044	-148	73	678	4
554	1	1	2018-01-28 11:00:00	10388	10098	290	55	792	4
555	1	1	2018-01-28 12:00:00	10072	9990	82	43	410	4
556	1	1	2018-01-28 13:00:00	8936	9126	-190	54	750	4
557	1	1	2018-01-28 14:00:00	8928	8640	288	48	1464	8
558	1	1	2018-01-28 15:00:00	7226	7398	-172	53	440	8
559	1	1	2018-01-28 16:00:00	1807	1620	187	57	238	4
560	1	1	2018-01-28 17:00:00	9560	9504	56	47	252	4
561	1	1	2018-01-28 18:00:00	9180	9180	0	45	262	4
562	1	1	2018-01-28 19:00:00	9068	8910	158	47	362	4
563	1	1	2018-01-28 20:00:00	9460	9396	64	56	288	4
564	1	1	2018-01-28 21:00:00	9771	9774	-3	48	346	4
565	1	1	2018-01-28 22:00:00	9668	9612	56	36	838	8
566	1	1	2018-01-28 23:00:00	10099	10044	55	98	898	8
567	1	1	2018-01-29 00:00:00	8656	8586	70	67	1066	4
568	1	1	2018-01-29 01:00:00	7586	7506	80	97	562	4
569	1	1	2018-01-29 02:00:00	8720	8694	26	93	902	4
570	1	1	2018-01-29 03:00:00	9166	9126	40	48	744	4
571	1	1	2018-01-29 04:00:00	9696	9666	30	48	1028	4
572	1	1	2018-01-29 05:00:00	9344	9234	110	67	514	4
573	1	1	2018-01-29 06:00:00	7412	7398	14	68	820	8
574	1	1	2018-01-29 07:00:00	2699	2538	161	50	242	4
575	1	1	2018-01-29 08:00:00	8508	8478	30	43	572	4
576	1	1	2018-01-29 09:00:00	5656	5670	-14	51	788	4
577	1	1	2018-01-29 10:00:00	8720	8586	134	80	634	4
578	1	1	2018-01-29 11:00:00	5076	5022	54	56	1234	4
579	1	1	2018-01-29 12:00:00	4576	4590	-14	86	970	4
580	1	1	2018-01-29 13:00:00	5648	5400	248	76	906	4
581	1	1	2018-01-29 14:00:00	9312	9288	24	2	3680	8
582	1	1	2018-01-29 15:00:00	610	684	-74	31	684	8
583	1	1	2018-01-29 16:00:00	8667	8478	189	34	278	4
584	1	1	2018-01-29 17:00:00	7105	7074	31	44	552	4
585	1	1	2018-01-29 18:00:00	9739	9612	127	51	248	4
586	1	1	2018-01-29 19:00:00	7480	7398	82	42	310	4
587	1	1	2018-01-29 20:00:00	6631	6480	151	56	438	4
588	1	1	2018-01-29 21:00:00	9098	9018	80	51	378	4
589	1	1	2018-01-29 22:00:00	8385	8316	69	15	3596	8
590	1	1	2018-01-29 23:00:00	9838	9774	64	78	696	8
591	1	1	2018-01-30 00:00:00	7706	7668	38	29	8420	4
592	1	1	2018-01-30 01:00:00	9939	9720	219	115	1066	4
593	1	1	2018-01-30 02:00:00	9795	9774	21	140	888	4
594	1	1	2018-01-30 03:00:00	7491	7398	93	83	578	4
595	1	1	2018-01-30 04:00:00	8184	8046	138	75	1770	4
596	1	1	2018-01-30 05:00:00	9183	9126	57	121	1156	4
597	1	1	2018-01-30 06:00:00	5502	5238	264	60	490	8
598	1	1	2018-01-30 15:00:00	6807	6696	111	31	328	8
599	1	1	2018-01-30 16:00:00	8392	8316	76	34	442	4
600	1	1	2018-01-30 17:00:00	3859	3726	133	60	508	4
601	1	1	2018-01-30 18:00:00	8691	8478	213	28	1622	4
602	1	1	2018-01-30 19:00:00	9535	9504	31	24	2028	4
603	1	1	2018-01-30 20:00:00	8680	8424	256	34	474	4
604	1	1	2018-01-30 21:00:00	8252	8154	98	42	440	4
605	1	1	2018-01-30 22:00:00	8783	8694	89	48	1408	8
606	1	1	2018-01-30 23:00:00	6763	6588	175	40	520	8
607	1	1	2018-01-31 00:00:00	5951	5886	65	62	1212	4
608	1	1	2018-01-31 01:00:00	9260	9072	188	64	1006	4
609	1	1	2018-01-31 02:00:00	8848	8730	118	29	3360	4
610	1	1	2018-01-31 03:00:00	8871	8748	123	17	5396	4
611	1	1	2018-01-31 04:00:00	9084	8964	120	23	2156	4
612	1	1	2018-01-31 05:00:00	8604	8370	234	19	3130	6
613	1	1	2018-01-31 06:00:00	7114	7020	94	14	5776	4
614	1	1	2018-01-31 07:00:00	9119	9180	-61	16	840	2
615	1	1	2018-01-31 08:00:00	3004	2700	304	62	970	6
616	1	1	2018-01-31 09:00:00	9147	9072	75	7	2982	6
617	1	1	2018-01-31 10:00:00	1684	1620	64	88	1362	6
618	1	1	2018-01-31 11:00:00	7476	7398	78	48	648	6
619	1	1	2018-01-31 12:00:00	5505	5922	-417	63	1050	6
620	1	1	2018-01-31 13:00:00	4969	4482	487	39	714	6
621	1	1	2018-01-31 14:00:00	6980	6642	338	25	570	12
622	1	1	2018-01-31 15:00:00	5216	5238	-22	42	674	12
623	1	1	2018-01-31 16:00:00	8735	8640	95	54	538	6
624	1	1	2018-01-31 17:00:00	9023	8838	185	53	412	6
625	1	1	2018-01-31 18:00:00	8108	7992	116	60	676	6
626	1	1	2018-01-31 19:00:00	8444	8460	-16	54	610	6
627	1	1	2018-01-31 20:00:00	9247	9036	211	44	532	6
628	1	1	2018-01-31 21:00:00	8847	8748	99	57	500	6
629	1	1	2018-01-31 22:00:00	5594	5346	248	64	802	12
630	1	1	2018-01-31 23:00:00	7272	7182	90	43	734	15
631	1	1	2018-02-01 00:00:00	6552	6426	126	13	2994	3
632	1	1	2018-02-01 01:00:00	8132	8046	86	42	714	3
633	1	1	2018-02-01 02:00:00	5032	4860	172	45	932	3
634	1	1	2018-02-01 03:00:00	8008	7938	70	68	866	3
635	1	1	2018-02-01 04:00:00	9815	9720	95	48	774	3
636	1	1	2018-02-01 05:00:00	9688	9504	184	50	600	3
637	1	1	2018-02-01 06:00:00	6671	6588	83	51	536	6
638	1	1	2018-02-01 07:00:00	1108	1080	28	84	814	3
639	1	1	2018-02-01 08:00:00	4164	3996	168	27	586	3
640	1	1	2018-02-01 09:00:00	9584	9504	80	44	4806	3
641	1	1	2018-02-01 10:00:00	5968	5778	190	51	570	3
642	1	1	2018-02-01 11:00:00	9308	9126	182	81	1762	3
643	1	1	2018-02-01 12:00:00	9308	9072	236	62	806	3
644	1	1	2018-02-01 13:00:00	5545	5346	199	47	724	3
645	1	1	2018-02-01 14:00:00	8569	8424	145	103	1708	6
646	1	1	2018-02-01 15:00:00	8812	8802	10	49	1260	6
647	1	1	2018-02-01 16:00:00	5962	5832	130	39	928	3
648	1	1	2018-02-01 17:00:00	7376	7020	356	54	3420	3
649	1	1	2018-02-01 18:00:00	7716	7560	156	19	406	3
650	1	1	2018-02-01 19:00:00	7125	7074	51	37	404	3
651	1	1	2018-02-01 20:00:00	3388	3240	148	36	1780	3
652	1	1	2018-02-01 21:00:00	9554	9396	158	45	1096	3
653	1	1	2018-02-01 22:00:00	7748	7776	-28	39	956	6
654	1	1	2018-02-01 23:00:00	5420	5238	182	44	1118	6
655	1	1	2018-02-02 00:00:00	9834	9720	114	43	1326	3
656	1	1	2018-02-02 01:00:00	8392	8262	130	45	1864	3
657	1	1	2018-02-02 02:00:00	8912	8694	218	1	6142	3
658	1	1	2018-02-02 03:00:00	8240	8208	32	23	246	3
659	1	1	2018-02-02 04:00:00	6226	6048	178	1	3042	3
660	1	1	2018-02-02 05:00:00	6944	7326	-382	36	4126	3
661	1	2	2018-02-02 08:00:00	1711	1242	469	37	400	3
662	1	2	2018-02-02 09:00:00	6076	6102	-26	51	3052	3
663	1	2	2018-02-02 13:00:00	576	432	144	34	602	3
664	1	2	2018-02-02 14:00:00	8036	7884	152	56	1058	6
665	1	2	2018-02-02 15:00:00	8024	8046	-22	21	4380	6
666	1	2	2018-02-02 16:00:00	7700	7560	140	2	122	3
667	1	2	2018-02-02 17:00:00	664	864	-200	24	228	3
668	1	2	2018-02-02 18:00:00	10252	9936	316	59	534	3
669	1	2	2018-02-02 19:00:00	9572	9504	68	27	180	3
670	1	2	2018-02-02 20:00:00	10428	10368	60	56	452	3
671	1	2	2018-02-02 21:00:00	9632	9558	74	47	454	3
672	1	2	2018-02-02 22:00:00	9731	9774	-43	45	310	6
673	1	2	2018-02-02 23:00:00	10216	9990	226	38	522	6
674	1	2	2018-02-03 00:00:00	9547	9612	-65	54	284	3
675	1	2	2018-02-03 01:00:00	10224	10044	180	111	882	3
676	1	2	2018-02-03 02:00:00	8207	8208	-1	92	576	3
677	1	2	2018-02-03 03:00:00	9243	9126	117	146	1112	3
678	1	2	2018-02-03 04:00:00	7504	7506	-2	31	1538	3
679	1	2	2018-02-03 05:00:00	6536	6480	56	36	690	3
680	1	2	2018-02-03 06:00:00	8708	8640	68	47	490	6
681	1	2	2018-02-03 07:00:00	9720	9666	54	53	826	3
682	1	2	2018-02-03 08:00:00	8324	8208	116	39	360	3
683	1	2	2018-02-03 09:00:00	10008	9990	18	53	1260	3
684	1	2	2018-02-03 10:00:00	7100	7074	26	57	452	3
685	1	2	2018-02-03 11:00:00	9724	9612	112	54	454	3
686	1	2	2018-02-03 12:00:00	9844	9774	70	111	720	3
687	1	2	2018-02-03 13:00:00	8772	8694	78	57	352	3
688	1	2	2018-02-03 14:00:00	10011	9936	75	52	580	6
689	1	2	2018-02-03 15:00:00	9159	9180	-21	55	392	6
690	1	2	2018-02-03 16:00:00	9896	9774	122	39	396	3
691	1	2	2018-02-03 17:00:00	10056	9990	66	42	560	3
692	1	2	2018-02-03 18:00:00	9168	9126	42	32	280	3
693	1	2	2018-02-03 19:00:00	10628	10530	98	46	630	3
694	1	2	2018-02-03 20:00:00	8756	8694	62	43	910	3
695	1	2	2018-02-03 21:00:00	8252	8262	-10	39	3826	3
696	1	2	2018-02-03 22:00:00	4768	5256	-488	16	302	6
697	1	2	2018-02-03 23:00:00	7516	3888	3628	38	120	6
698	1	2	2018-02-04 00:00:00	10784	10638	146	33	524	3
699	1	2	2018-02-04 01:00:00	9564	9558	6	22	566	3
700	1	2	2018-02-04 02:00:00	9300	9072	228	44	460	3
701	1	2	2018-02-04 03:00:00	9676	9558	118	19	76	3
702	1	2	2018-02-04 04:00:00	10872	10854	18	17	1670	3
703	1	2	2018-02-04 05:00:00	6068	5922	146	27	330	3
704	1	2	2018-02-04 06:00:00	10064	9990	74	25	502	6
705	1	2	2018-02-04 07:00:00	9576	9504	72	35	458	3
706	1	2	2018-02-04 08:00:00	9708	9666	42	55	2814	3
707	1	2	2018-02-04 09:00:00	8268	8208	60	9	412	3
708	1	2	2018-02-04 10:00:00	4044	3996	48	53	346	7
709	1	2	2018-02-04 11:00:00	10012	9936	76	21	156	7
710	1	2	2018-02-04 12:00:00	10680	10638	42	50	442	11
711	1	2	2018-02-04 13:00:00	9752	9666	86	49	608	4
712	1	2	2018-02-04 14:00:00	9304	9180	124	35	452	23
713	1	2	2018-02-04 15:00:00	9818	9720	98	33	414	3
714	1	2	2018-02-04 16:00:00	9942	9882	60	19	418	3
715	1	2	2018-02-04 17:00:00	9712	9720	-8	27	148	3
716	1	2	2018-02-04 18:00:00	10696	10692	4	44	320	3
717	1	2	2018-02-04 19:00:00	10123	9990	133	18	332	3
718	1	2	2018-02-04 20:00:00	10095	9936	159	24	468	3
719	1	2	2018-02-04 21:00:00	9712	9612	100	50	398	3
720	1	2	2018-02-04 22:00:00	10052	9990	62	111	760	6
721	1	2	2018-02-04 23:00:00	8563	8478	85	34	546	6
722	1	2	2018-02-05 00:00:00	9312	9126	186	22	424	3
723	1	2	2018-02-05 01:00:00	9852	9882	-30	22	252	3
724	1	2	2018-02-05 02:00:00	10328	10206	122	23	522	3
725	1	2	2018-02-05 03:00:00	9508	9396	112	62	302	3
726	1	2	2018-02-05 04:00:00	10138	10044	94	34	394	3
727	1	2	2018-02-05 05:00:00	9756	9774	-18	46	830	3
728	1	2	2018-02-05 06:00:00	9124	8910	214	13	2274	6
729	1	2	2018-02-05 07:00:00	3600	3564	36	31	3796	3
730	1	2	2018-02-05 08:00:00	1302	1836	-534	30	3220	3
731	1	2	2018-02-05 09:00:00	3178	2646	532	29	334	3
732	1	2	2018-02-05 10:00:00	5806	5724	82	20	486	3
733	1	2	2018-02-05 11:00:00	9788	9720	68	79	762	3
734	1	2	2018-02-05 12:00:00	8359	8100	259	22	844	3
735	1	2	2018-02-05 13:00:00	8412	8316	96	15	2048	3
736	1	2	2018-02-05 14:00:00	6196	6102	94	10	2146	6
737	1	2	2018-02-05 15:00:00	3512	3294	218	19	2312	6
738	1	2	2018-02-05 16:00:00	3142	3222	-80	37	752	8
739	1	7	2018-02-05 16:00:00	3142	3222	-80	37	752	8
740	1	7	2018-02-05 17:00:00	8888	8640	248	41	1198	8
741	1	7	2018-02-05 18:00:00	7291	7074	217	128	904	8
742	1	7	2018-02-05 19:00:00	8259	8262	-3	89	1676	8
743	1	7	2018-02-05 20:00:00	5804	5616	188	104	1006	8
744	1	7	2018-02-05 21:00:00	7876	7776	100	40	376	8
745	1	7	2018-02-05 22:00:00	9824	9720	104	90	812	16
746	1	7	2018-02-05 23:00:00	8484	8316	168	61	444	16
747	1	7	2018-02-06 00:00:00	9624	9558	66	58	506	8
748	1	7	2018-02-06 01:00:00	9640	9558	82	36	2176	8
749	1	7	2018-02-06 02:00:00	4372	4266	106	68	1254	8
750	1	7	2018-02-06 03:00:00	7420	7020	400	82	634	8
751	1	7	2018-02-06 04:00:00	8740	8640	100	76	476	8
752	1	7	2018-02-06 05:00:00	9560	9612	-52	33	720	8
753	1	7	2018-02-06 06:00:00	9072	8802	270	45	876	16
754	1	7	2018-02-06 07:00:00	7953	7992	-39	6	3686	8
755	1	7	2018-02-06 08:00:00	38	378	-340	30	984	8
756	1	4	2018-02-06 09:00:00	7712	7128	584	24	904	8
757	1	4	2018-02-06 10:00:00	8116	7938	178	36	790	8
758	1	4	2018-02-06 11:00:00	8507	8370	137	51	1702	8
759	1	4	2018-02-06 12:00:00	5927	5868	59	21	4764	8
760	1	4	2018-02-06 13:00:00	1528	2052	-524	19	238	8
761	1	16	2018-02-06 14:00:00	4965	4266	699	24	328	16
762	1	16	2018-02-06 15:00:00	10052	9936	116	47	806	16
763	1	16	2018-02-06 16:00:00	8456	8262	194	36	772	8
764	1	16	2018-02-06 17:00:00	8700	8640	60	37	484	8
765	1	16	2018-02-06 18:00:00	9286	9072	214	90	660	8
766	1	16	2018-02-06 19:00:00	9111	8964	147	31	3480	8
767	1	16	2018-02-06 20:00:00	873	1422	-549	1	4058	8
768	1	1	2018-02-06 22:00:00	6832	6588	244	40	4230	19
769	1	1	2018-02-06 23:00:00	2440	2376	64	13	1562	14
770	1	1	2018-02-07 00:00:00	2188	2160	28	48	1244	7
771	1	1	2018-02-07 01:00:00	6903	6750	153	40	304	7
772	1	1	2018-02-07 02:00:00	10142	10098	44	47	278	7
773	1	1	2018-02-07 03:00:00	10256	10098	158	88	952	7
774	1	1	2018-02-07 04:00:00	8108	8046	62	127	850	7
775	1	1	2018-02-07 05:00:00	8371	8262	109	106	1278	7
776	1	1	2018-02-07 06:00:00	7095	7074	21	73	1670	14
777	1	1	2018-02-07 07:00:00	5658	5454	204	58	576	7
778	1	1	2018-02-07 08:00:00	9351	9342	9	12	6512	7
779	1	1	2018-02-07 09:00:00	1624	1602	22	68	336	7
780	1	1	2018-02-07 10:00:00	572	378	194	91	614	7
781	1	1	2018-02-07 11:00:00	5456	5400	56	129	376	7
782	1	1	2018-02-07 12:00:00	7428	7344	84	122	404	7
783	1	1	2018-02-07 13:00:00	8420	8370	50	121	438	7
784	1	1	2018-02-07 14:00:00	7479	7398	81	73	1982	14
785	1	1	2018-02-07 15:00:00	7176	7074	102	44	1192	14
786	1	1	2018-02-07 16:00:00	6591	6426	165	55	806	7
787	1	1	2018-02-07 17:00:00	8531	8424	107	21	2176	7
788	1	1	2018-02-07 18:00:00	8471	8424	47	44	1218	7
789	1	1	2018-02-07 19:00:00	8904	8748	156	7	5408	7
790	1	1	2018-02-07 20:00:00	7997	7776	221	4	1234	7
791	1	1	2018-02-07 21:00:00	8260	8316	-56	51	462	7
792	1	1	2018-02-07 22:00:00	8901	8640	261	64	356	14
793	1	1	2018-02-07 23:00:00	5778	5670	108	47	778	14
794	1	1	2018-02-08 00:00:00	8899	8856	43	99	568	7
795	1	1	2018-02-08 01:00:00	7781	7776	5	66	952	7
796	1	1	2018-02-08 02:00:00	4889	4698	191	82	286	7
797	1	1	2018-02-08 03:00:00	7593	7614	-21	36	2360	7
798	1	1	2018-02-08 04:00:00	6360	6102	258	95	682	7
799	1	1	2018-02-08 05:00:00	8232	8154	78	81	716	7
800	1	1	2018-02-08 06:00:00	8956	8892	64	89	668	14
801	1	1	2018-02-08 07:00:00	8274	8208	66	106	548	7
802	1	1	2018-02-08 08:00:00	8976	8964	12	95	1372	7
803	1	1	2018-02-08 09:00:00	6061	5994	67	76	992	7
804	1	1	2018-02-08 10:00:00	6372	6372	0	60	1944	7
805	1	1	2018-02-08 11:00:00	5204	5130	74	84	764	7
806	1	1	2018-02-08 12:00:00	7830	7776	54	112	970	7
807	1	1	2018-02-08 13:00:00	8240	8208	32	43	2388	7
808	1	1	2018-02-08 14:00:00	6424	6318	106	102	584	14
809	1	1	2018-02-08 15:00:00	4764	5238	-474	104	840	14
810	1	5	2018-02-08 17:00:00	7928	7866	62	22	5446	7
811	1	5	2018-02-08 18:00:00	9635	9612	23	9	166	7
812	1	5	2018-02-08 19:00:00	10338	10314	24	54	338	7
813	1	5	2018-02-08 20:00:00	10340	10260	80	64	304	7
814	1	5	2018-02-08 21:00:00	5396	5508	-112	65	4974	7
815	1	5	2018-02-08 22:00:00	3251	2916	335	29	906	14
816	1	5	2018-02-08 23:00:00	10431	10260	171	52	370	14
817	1	5	2018-02-09 00:00:00	9344	9396	-52	62	774	7
818	1	5	2018-02-09 01:00:00	7788	7506	282	47	550	7
819	1	5	2018-02-09 02:00:00	10004	9882	122	50	216	7
820	1	5	2018-02-09 03:00:00	8524	8370	154	65	524	7
821	1	5	2018-02-09 04:00:00	10424	10422	2	45	1640	7
822	1	5	2018-02-09 05:00:00	6628	6642	-14	14	6738	7
823	1	5	2018-02-09 08:00:00	3256	3348	-92	9	178	7
824	1	5	2018-02-09 09:00:00	172	54	118	73	920	7
825	1	5	2018-02-09 10:00:00	1840	1836	4	37	422	7
826	1	5	2018-02-09 11:00:00	9320	9126	194	82	766	7
827	1	5	2018-02-09 12:00:00	9738	9720	18	56	552	4
828	1	5	2018-02-09 13:00:00	8690	8586	104	53	960	7
829	1	5	2018-02-09 14:00:00	9227	9126	101	51	814	6
830	1	5	2018-02-09 15:00:00	8156	8100	56	19	5188	6
831	1	5	2018-02-09 16:00:00	8512	8478	34	16	358	3
832	1	5	2018-02-09 17:00:00	1532	2034	-502	76	888	3
833	1	1	2018-02-09 18:00:00	3554	2916	638	73	582	3
834	1	1	2018-02-09 19:00:00	8575	8424	151	82	320	3
835	1	1	2018-02-09 20:00:00	9120	9072	48	95	520	3
836	1	1	2018-02-09 21:00:00	9772	9612	160	114	518	3
837	1	1	2018-02-09 22:00:00	9284	9234	50	105	606	6
838	1	1	2018-02-09 23:00:00	9380	9342	38	117	354	6
839	1	1	2018-02-10 00:00:00	9011	8802	209	111	590	3
840	1	1	2018-02-10 01:00:00	9836	9774	62	144	694	3
841	1	1	2018-02-10 02:00:00	9043	8964	79	64	2562	3
842	1	1	2018-02-10 03:00:00	8764	8640	124	69	936	3
843	1	1	2018-02-10 04:00:00	4378	4914	-536	115	490	3
844	1	1	2018-02-10 05:00:00	6734	6300	434	126	440	3
845	1	1	2018-02-10 06:00:00	9472	9234	238	120	1528	6
846	1	1	2018-02-10 07:00:00	9532	9450	82	91	712	3
847	1	1	2018-02-10 08:00:00	7773	7722	51	113	778	3
848	1	1	2018-02-10 09:00:00	7123	6966	157	112	492	3
849	1	1	2018-02-10 10:00:00	8471	8424	47	90	1746	3
850	1	1	2018-02-10 11:00:00	9451	9396	55	98	588	3
851	1	1	2018-02-10 12:00:00	5468	5400	68	121	1266	3
852	1	1	2018-02-10 13:00:00	9139	9072	67	78	1180	3
853	1	1	2018-02-10 14:00:00	7093	7020	73	100	748	6
854	1	1	2018-02-10 15:00:00	7231	7074	157	108	1128	6
855	1	1	2018-02-10 16:00:00	8603	8586	17	84	1176	3
856	1	1	2018-02-10 17:00:00	7764	7722	42	109	968	3
857	1	1	2018-02-10 18:00:00	7150	7074	76	102	968	3
858	1	1	2018-02-10 19:00:00	8472	8370	102	131	596	3
859	1	1	2018-02-10 20:00:00	7562	7344	218	128	886	3
860	1	1	2018-02-10 21:00:00	8864	8748	116	137	390	3
861	1	1	2018-02-10 22:00:00	8016	7938	78	164	658	6
862	1	1	2018-02-10 23:00:00	9620	9558	62	193	508	6
863	1	1	2018-02-11 00:00:00	8695	8640	55	150	444	3
864	1	1	2018-02-11 01:00:00	9404	9342	62	161	544	3
865	1	1	2018-02-11 02:00:00	9224	9180	44	81	542	3
866	1	1	2018-02-11 03:00:00	9235	9180	55	70	482	3
867	1	1	2018-02-11 04:00:00	9414	9342	72	109	534	3
868	1	1	2018-02-11 05:00:00	9368	9342	26	101	498	3
869	1	1	2018-02-11 06:00:00	9292	9234	58	105	532	6
870	1	1	2018-02-11 07:00:00	9399	9342	57	97	382	3
871	1	1	2018-02-11 08:00:00	9316	9288	28	122	452	3
872	1	1	2018-02-11 09:00:00	9692	9612	80	83	1070	3
873	1	1	2018-02-11 10:00:00	9536	9504	32	109	730	3
874	1	1	2018-02-11 11:00:00	7756	7722	34	84	570	3
875	1	1	2018-02-11 12:00:00	8600	8586	14	125	1056	3
876	1	1	2018-02-11 13:00:00	9152	9072	80	48	2520	3
877	1	1	2018-02-11 14:00:00	7704	7722	-18	24	534	6
878	1	1	2018-02-11 15:00:00	4562	5022	-460	57	642	6
879	1	1	2018-02-11 16:00:00	8321	7668	653	79	1226	3
880	1	1	2018-02-11 17:00:00	8947	8910	37	73	610	3
881	1	1	2018-02-11 18:00:00	7220	7398	-178	115	288	6
882	1	1	2018-02-11 19:00:00	9356	9234	122	135	672	3
883	1	1	2018-02-11 20:00:00	10000	9990	10	113	546	3
884	1	1	2018-02-11 21:00:00	8841	8748	93	102	734	3
885	1	1	2018-02-11 22:00:00	9219	9234	-15	100	1376	6
886	1	1	2018-02-11 23:00:00	8688	8532	156	62	570	6
887	1	1	2018-02-12 00:00:00	7609	7290	319	93	526	3
888	1	1	2018-02-12 01:00:00	8584	8532	52	113	824	3
889	1	1	2018-02-12 02:00:00	8988	8964	24	77	458	3
890	1	1	2018-02-12 03:00:00	8627	8640	-13	60	1174	3
891	1	1	2018-02-12 04:00:00	9513	9342	171	70	5074	3
892	1	1	2018-02-12 05:00:00	7608	7614	-6	67	346	3
893	1	1	2018-02-12 06:00:00	8600	8532	68	47	652	6
894	1	1	2018-02-12 07:00:00	20	0	20	1	7634	3
895	1	1	2018-02-12 08:00:00	244	270	-26	27	396	3
896	1	1	2018-02-12 09:00:00	4724	4878	-154	51	436	3
897	1	1	2018-02-12 11:00:00	12	0	12	79	478	3
898	1	1	2018-02-12 12:00:00	505	486	19	92	680	3
899	1	1	2018-02-12 13:00:00	224	216	8	68	972	3
900	1	1	2018-02-12 14:00:00	2508	2322	186	46	310	6
901	1	1	2018-02-12 15:00:00	9040	8964	76	52	396	6
902	1	1	2018-02-12 16:00:00	8340	8262	78	62	568	3
903	1	1	2018-02-12 17:00:00	7365	7020	345	43	1046	3
904	1	1	2018-02-12 18:00:00	9832	9774	58	80	752	3
905	1	1	2018-02-12 19:00:00	9036	9018	18	61	476	3
906	1	1	2018-02-12 20:00:00	8794	8748	46	47	1234	3
907	1	1	2018-02-12 21:00:00	10000	9936	64	93	586	3
908	1	1	2018-02-12 22:00:00	9072	9126	-54	48	716	6
909	1	1	2018-02-12 23:00:00	6920	6804	116	66	576	6
910	1	1	2018-02-13 00:00:00	4340	4320	20	79	548	3
911	1	1	2018-02-13 01:00:00	7152	7074	78	26	7830	3
912	1	1	2018-02-13 02:00:00	8959	8910	49	60	1346	3
913	1	1	2018-02-13 03:00:00	6036	5994	42	80	506	3
914	1	1	2018-02-13 04:00:00	4859	4806	53	71	1138	3
915	1	1	2018-02-13 05:00:00	9054	9180	-126	6	3960	3
916	1	1	2018-02-13 06:00:00	6720	6480	240	44	220	6
917	1	1	2018-02-13 07:00:00	9476	9342	134	27	450	3
918	1	1	2018-02-13 08:00:00	7924	7992	-68	44	650	3
919	1	1	2018-02-13 09:00:00	178	666	-488	48	320	3
920	1	1	2018-02-13 10:00:00	8185	7560	625	40	896	3
921	1	1	2018-02-13 11:00:00	8616	8532	84	31	444	3
922	1	1	2018-02-13 12:00:00	10044	9990	54	52	532	3
923	1	1	2018-02-13 13:00:00	8264	8262	2	36	456	3
924	1	1	2018-02-13 14:00:00	9700	9666	34	51	1450	6
925	1	1	2018-02-13 15:00:00	9459	9288	171	32	958	6
926	1	1	2018-02-13 16:00:00	9707	9666	41	53	852	3
927	1	1	2018-02-13 17:00:00	6518	6534	-16	62	374	3
928	1	1	2018-02-13 18:00:00	8042	7992	50	32	370	3
929	1	1	2018-02-13 19:00:00	8479	8316	163	62	842	3
930	1	1	2018-02-13 20:00:00	9856	9882	-26	45	784	3
931	1	1	2018-02-13 21:00:00	10019	9882	137	63	444	3
932	1	1	2018-02-13 22:00:00	8501	8460	41	45	1142	6
933	1	1	2018-02-13 23:00:00	8520	8532	-12	33	346	6
934	1	1	2018-02-14 00:00:00	9914	9774	140	25	850	3
935	1	1	2018-02-14 01:00:00	7552	7470	82	55	960	3
936	1	1	2018-02-14 02:00:00	9884	9828	56	48	9966	3
937	1	1	2018-02-14 03:00:00	8500	8424	76	13	31286	3
938	1	1	2018-02-14 04:00:00	8022	7992	30	32	250	3
939	1	1	2018-02-14 05:00:00	9400	9234	166	49	588	3
940	1	1	2018-02-14 06:00:00	68	216	-148	59	764	6
941	1	1	2018-02-14 08:00:00	3579	3564	15	7	142	7
942	1	1	2018-02-14 09:00:00	10308	10152	156	42	464	4
943	1	1	2018-02-14 10:00:00	8491	8370	121	40	2350	4
944	1	1	2018-02-14 11:00:00	9272	9234	38	56	462	4
945	1	1	2018-02-14 12:00:00	9106	9126	-20	31	1474	4
946	1	1	2018-02-14 13:00:00	8451	8316	135	58	442	4
947	1	1	2018-02-14 14:00:00	9336	9288	48	30	2372	8
948	1	1	2018-02-14 15:00:00	8808	8748	60	58	536	8
949	1	1	2018-02-14 16:00:00	9690	9504	186	67	358	4
950	1	1	2018-02-14 17:00:00	9816	9774	42	53	366	4
951	1	1	2018-02-14 18:00:00	9564	9558	6	29	1774	4
952	1	1	2018-02-14 19:00:00	7508	7452	56	1	3290	4
953	1	1	2018-02-14 20:00:00	10268	10152	116	2	154	4
954	1	1	2018-02-14 21:00:00	2666	3168	-502	42	622	7
955	1	2	2018-02-15 00:00:00	2489	1836	653	36	2974	7
956	1	2	2018-02-15 01:00:00	9044	8964	80	44	848	7
957	1	2	2018-02-15 02:00:00	9147	8910	237	96	1166	7
958	1	2	2018-02-15 03:00:00	3407	3402	5	61	1082	7
959	1	2	2018-02-15 04:00:00	6848	6696	152	74	932	7
960	1	2	2018-02-15 05:00:00	7372	7344	28	160	930	7
961	1	2	2018-02-15 06:00:00	7996	7776	220	90	868	14
962	1	2	2018-02-15 07:00:00	7807	7668	139	36	1836	7
963	1	2	2018-02-15 08:00:00	8092	8100	-8	1	7076	7
964	1	2	2018-02-15 09:00:00	7991	7722	269	68	642	7
965	1	2	2018-02-15 10:00:00	6444	6876	-432	72	326	7
966	1	1	2018-02-15 13:00:00	8899	8532	367	38	494	7
967	1	1	2018-02-15 14:00:00	10448	10422	26	27	200	14
968	1	1	2018-02-15 15:00:00	8280	8208	72	67	400	14
969	1	1	2018-02-15 16:00:00	9564	9504	60	40	832	7
970	1	1	2018-02-15 17:00:00	10644	10584	60	54	746	7
971	1	1	2018-02-15 18:00:00	9728	9720	8	52	486	7
972	1	1	2018-02-15 19:00:00	8526	8478	48	49	456	7
973	1	1	2018-02-15 20:00:00	8928	8856	72	24	304	7
974	1	1	2018-02-15 21:00:00	9643	9504	139	53	236	7
975	1	1	2018-02-15 22:00:00	9516	9540	-24	42	486	14
976	1	1	2018-02-15 23:00:00	10416	10314	102	37	316	14
977	1	1	2018-02-16 00:00:00	10172	10134	38	58	272	7
978	1	1	2018-02-16 01:00:00	9926	9990	-64	42	344	7
979	1	1	2018-02-16 02:00:00	9952	9774	178	30	488	7
980	1	1	2018-02-16 03:00:00	10028	9990	38	45	306	7
981	1	1	2018-02-16 04:00:00	10035	9936	99	20	8906	7
982	1	1	2018-02-16 05:00:00	9628	9558	70	85	986	7
983	1	1	2018-02-16 06:00:00	10184	10098	86	126	556	14
984	1	1	2018-02-16 07:00:00	5356	5400	-44	124	342	7
985	1	1	2018-02-16 09:00:00	16	108	-92	67	502	7
986	1	1	2018-02-16 10:00:00	6136	5886	250	38	680	7
987	1	1	2018-02-16 11:00:00	7352	7236	116	49	528	7
988	1	1	2018-02-16 12:00:00	9628	9612	16	57	662	7
989	1	1	2018-02-16 13:00:00	8875	8694	181	51	418	7
990	1	1	2018-02-16 14:00:00	9445	9342	103	43	740	14
991	1	1	2018-02-16 15:00:00	9264	9180	84	25	344	14
992	1	1	2018-02-16 16:00:00	9586	9504	82	48	412	7
993	1	1	2018-02-16 17:00:00	8762	8964	-202	36	436	7
994	1	1	2018-02-16 18:00:00	10088	9774	314	41	2398	7
995	1	1	2018-02-16 19:00:00	9735	9774	-39	35	1960	7
996	1	1	2018-02-16 20:00:00	9792	9666	126	28	2306	7
997	1	1	2018-02-16 21:00:00	4065	4104	-39	66	560	7
998	1	1	2018-02-16 22:00:00	6431	6372	59	47	634	15
999	1	1	2018-02-16 23:00:00	2006	1890	116	78	322	7
1000	1	1	2018-02-16 23:00:00	2006	1890	116	78	322	7
1001	1	1	2018-02-17 00:00:00	9260	9180	80	118	744	4
1002	1	1	2018-02-17 01:00:00	9143	9072	71	125	498	4
1003	1	1	2018-02-17 02:00:00	9948	9990	-42	124	646	4
1004	1	1	2018-02-17 03:00:00	8830	8748	82	142	856	4
1005	1	1	2018-02-17 04:00:00	9312	9180	132	84	1958	4
1006	1	1	2018-02-17 05:00:00	8912	8910	2	109	664	4
1007	1	1	2018-02-17 06:00:00	8264	8262	2	25	2236	8
1008	1	1	2018-02-17 07:00:00	5072	5076	-4	33	922	4
1009	1	1	2018-02-17 08:00:00	8724	8586	138	58	720	4
1010	1	1	2018-02-17 09:00:00	5784	5886	-102	67	608	4
1011	1	1	2018-02-17 10:00:00	7996	7668	328	57	414	4
1012	1	1	2018-02-17 11:00:00	7596	7614	-18	50	490	4
1013	1	1	2018-02-17 12:00:00	9222	9018	204	67	512	4
1014	1	1	2018-02-17 13:00:00	9656	9666	-10	63	522	4
1015	1	1	2018-02-17 14:00:00	9600	9504	96	42	826	8
1016	1	1	2018-02-17 15:00:00	9524	9396	128	54	466	12
1017	1	1	2018-02-17 16:00:00	9348	9378	-30	57	830	4
1018	1	1	2018-02-17 17:00:00	8656	8532	124	39	412	4
1019	1	1	2018-02-17 18:00:00	9572	9504	68	78	980	4
1020	1	1	2018-02-17 19:00:00	8588	8478	110	57	502	4
1021	1	1	2018-02-17 20:00:00	9588	9558	30	54	230	4
1022	1	1	2018-02-17 21:00:00	8440	8370	70	43	292	4
1023	1	1	2018-02-17 22:00:00	9060	8964	96	55	480	8
1024	1	1	2018-02-17 23:00:00	10348	10260	88	53	240	9
1025	1	1	2018-02-18 00:00:00	10244	10152	92	39	956	5
1026	1	1	2018-02-18 01:00:00	9656	9612	44	48	226	5
1027	1	1	2018-02-18 02:00:00	10128	10098	30	55	868	5
1028	1	1	2018-02-18 03:00:00	8200	8100	100	50	182	5
1029	1	1	2018-02-18 04:00:00	10416	10314	102	85	336	5
1030	1	1	2018-02-18 05:00:00	8523	8424	99	57	2258	5
1031	1	1	2018-02-18 06:00:00	10368	10314	54	1	4860	10
1032	1	1	2018-02-18 07:00:00	9956	9882	74	16	436	5
1033	1	1	2018-02-18 08:00:00	5730	6210	-480	31	280	5
1034	1	7	2018-02-18 10:00:00	7828	3888	3940	120	422	5
1035	1	7	2018-02-18 11:00:00	9920	9774	146	119	680	5
1036	1	7	2018-02-18 12:00:00	10440	10260	180	147	664	5
1037	1	7	2018-02-18 13:00:00	9964	9882	82	106	802	5
1038	1	7	2018-02-18 14:00:00	8751	8910	-159	54	358	12
1039	1	7	2018-02-18 15:00:00	8628	8316	312	60	1118	8
1040	1	7	2018-02-18 16:00:00	9724	9666	58	83	632	3
1041	1	7	2018-02-18 17:00:00	8952	8910	42	112	648	3
1042	1	7	2018-02-18 18:00:00	9660	9504	156	124	848	3
1043	1	7	2018-02-18 19:00:00	9040	9072	-32	79	780	7
1044	1	7	2018-02-18 20:00:00	7830	7668	162	93	966	7
1045	1	7	2018-02-18 21:00:00	9028	9126	-98	95	1108	7
1046	1	7	2018-02-18 22:00:00	9467	9234	233	118	978	14
1047	1	7	2018-02-18 23:00:00	9932	9828	104	100	694	14
1048	1	7	2018-02-19 00:00:00	10088	10044	44	144	514	7
1049	1	7	2018-02-19 01:00:00	9596	9558	38	113	462	7
1050	1	7	2018-02-19 02:00:00	10112	10044	68	174	546	7
1051	1	7	2018-02-19 03:00:00	10224	10098	126	146	726	7
1052	1	7	2018-02-19 04:00:00	8672	8640	32	129	690	7
1053	1	7	2018-02-19 05:00:00	9600	9504	96	94	12774	3
1054	1	7	2018-02-19 06:00:00	10219	10152	67	78	230	7
1055	1	7	2018-02-19 07:00:00	9976	9936	40	38	1116	4
1056	1	7	2018-02-19 08:00:00	9827	9774	53	62	456	4
1057	1	7	2018-02-19 09:00:00	10332	10206	126	18	3230	4
1058	1	7	2018-02-19 10:00:00	9280	9342	-62	37	3398	4
1059	1	7	2018-02-19 11:00:00	7760	7614	146	122	2492	4
1060	1	7	2018-02-19 12:00:00	9752	9720	32	2	4628	4
1061	1	7	2018-02-19 13:00:00	2251	2214	37	28	304	4
1062	1	7	2018-02-19 14:00:00	9044	9018	26	31	2740	8
1063	1	7	2018-02-19 15:00:00	3172	3672	-500	21	252	8
1064	1	7	2018-02-19 16:00:00	2506	2052	454	36	1182	4
1065	1	7	2018-02-19 17:00:00	9360	9126	234	52	794	4
1066	1	7	2018-02-19 18:00:00	8396	8208	188	67	828	4
1067	1	7	2018-02-19 19:00:00	8008	7992	16	62	1140	4
1068	1	7	2018-02-19 20:00:00	7515	7560	-45	2	7032	4
1069	1	7	2018-02-19 21:00:00	6353	6498	-145	7	124	8
1070	1	11	2018-02-19 22:00:00	1334	756	578	40	260	8
1071	1	11	2018-02-19 23:00:00	4008	3780	228	40	230	8
1072	1	11	2018-02-20 00:00:00	3708	3780	-72	42	678	4
1073	1	11	2018-02-20 01:00:00	1263	1152	111	10	3292	4
1074	1	9	2018-02-20 01:00:00	1263	1152	111	10	3292	4
1075	1	9	2018-02-20 02:00:00	2576	2376	200	51	568	4
1076	1	9	2018-02-20 03:00:00	5728	5508	220	61	350	4
1077	1	9	2018-02-20 04:00:00	7480	7074	406	33	472	4
1078	1	9	2018-02-20 05:00:00	3174	3582	-408	52	382	4
1079	1	4	2018-02-20 06:00:00	6330	5778	552	47	744	8
1080	1	4	2018-02-20 07:00:00	9744	9612	132	53	1286	4
1081	1	4	2018-02-20 08:00:00	9544	9396	148	61	2260	4
1082	1	4	2018-02-20 09:00:00	8600	8532	68	92	562	4
1083	1	4	2018-02-20 10:00:00	6127	5994	133	28	230	4
1084	1	4	2018-02-20 11:00:00	10212	10152	60	36	830	4
1085	1	4	2018-02-20 12:00:00	9032	8964	68	41	1152	4
1086	1	4	2018-02-20 13:00:00	8876	8802	74	45	1314	7
1087	1	4	2018-02-20 14:00:00	4374	4788	-414	10	4586	6
1088	1	14	2018-02-20 15:00:00	4185	3618	567	28	424	6
1089	1	14	2018-02-20 16:00:00	2691	2592	99	48	634	3
1090	1	14	2018-02-20 17:00:00	0	306	-306	74	1200	3
1091	1	13	2018-02-20 18:00:00	3054	2430	624	29	2220	3
1092	1	13	2018-02-20 19:00:00	7573	7398	175	57	1000	7
1093	1	13	2018-02-20 20:00:00	6028	5994	34	49	710	4
1094	1	13	2018-02-20 21:00:00	8167	7884	283	66	510	4
1095	1	13	2018-02-20 22:00:00	1655	2196	-541	42	470	8
1096	1	4	2018-02-20 23:00:00	3326	2754	572	81	746	8
1097	1	4	2018-02-21 00:00:00	9348	9126	222	134	1424	4
1098	1	4	2018-02-21 01:00:00	8976	8964	12	16	2830	4
1099	1	4	2018-02-21 02:00:00	10076	9936	140	30	2146	4
1100	1	4	2018-02-21 03:00:00	9566	9396	170	36	28978	4
1101	1	4	2018-02-21 04:00:00	8843	8856	-13	96	760	4
1102	1	4	2018-02-21 05:00:00	9740	9504	236	114	498	4
1103	1	4	2018-02-21 06:00:00	8911	8802	109	71	386	8
1104	1	4	2018-02-21 07:00:00	2848	2934	-86	89	534	4
1105	1	4	2018-02-21 07:00:00	2848	2934	-86	89	534	4
1106	1	4	2018-02-21 08:00:00	9080	8802	278	2	1632	4
1107	1	4	2018-02-21 09:00:00	8196	8154	42	86	1016	4
1108	1	4	2018-02-21 10:00:00	9332	9180	152	23	800	4
1109	1	4	2018-02-21 11:00:00	7872	7830	42	2	4122	4
1110	1	4	2018-02-21 12:00:00	9792	9666	126	58	964	4
1111	1	4	2018-02-21 13:00:00	9512	9396	116	106	586	4
1112	1	4	2018-02-21 14:00:00	9224	9288	-64	35	3906	8
1113	1	4	2018-02-21 15:00:00	7554	7884	-330	23	1548	8
1114	1	1	2018-02-21 17:00:00	7656	7074	582	32	376	4
1115	1	1	2018-02-21 18:00:00	9132	9072	60	56	386	4
1116	1	1	2018-02-21 19:00:00	9576	9578	-2	75	334	4
1117	1	1	2018-02-21 20:00:00	9608	9504	104	39	554	4
1118	1	1	2018-02-21 21:00:00	8952	8910	42	90	598	4
1119	1	1	2018-02-21 22:00:00	8788	8748	40	36	336	8
1120	1	1	2018-02-21 23:00:00	9683	9558	125	29	282	8
1121	1	1	2018-02-22 00:00:00	8964	8910	54	62	458	4
1122	1	1	2018-02-22 01:00:00	8908	8856	52	52	312	4
1123	1	1	2018-02-22 02:00:00	8888	8910	-22	45	544	4
1124	1	1	2018-02-22 03:00:00	8222	8154	68	48	426	4
1125	1	1	2018-02-22 04:00:00	8232	8046	186	62	1388	4
1126	1	1	2018-02-22 05:00:00	8612	8640	-28	16	1778	4
1127	1	1	2018-02-22 06:00:00	8294	8208	86	37	1452	11
1128	1	1	2018-02-22 07:00:00	9812	9774	38	60	500	3
1129	1	1	2018-02-22 08:00:00	8980	8910	70	89	1038	3
1130	1	1	2018-02-22 09:00:00	8068	8046	22	52	998	3
1131	1	1	2018-02-22 10:00:00	3988	3996	-8	32	192	3
1132	1	1	2018-02-22 11:00:00	9592	9504	88	46	426	3
1133	1	1	2018-02-22 12:00:00	8876	8856	20	30	482	3
1134	1	1	2018-02-22 13:00:00	7108	7074	34	43	346	3
1135	1	1	2018-02-22 14:00:00	8968	8910	58	21	1064	6
1136	1	1	2018-02-22 15:00:00	8119	8046	73	36	488	6
1137	1	1	2018-02-22 16:00:00	9148	9126	22	34	230	3
1138	1	1	2018-02-22 17:00:00	8420	8316	104	22	1158	3
1139	1	1	2018-02-22 18:00:00	9400	9396	4	35	494	3
1140	1	1	2018-02-22 19:00:00	7976	7938	38	39	134	3
1141	1	1	2018-02-22 20:00:00	8224	8154	70	22	1120	3
1142	1	1	2018-02-22 21:00:00	8056	8100	-44	35	674	3
1143	1	1	2018-02-22 22:00:00	7863	7722	141	31	846	6
1144	1	1	2018-02-22 23:00:00	6460	6426	34	38	1616	6
1145	1	1	2018-02-23 00:00:00	8232	8154	78	19	1188	3
1146	1	1	2018-02-23 01:00:00	8818	8802	16	48	346	3
1147	1	1	2018-02-23 02:00:00	8860	8802	58	47	3396	3
1148	1	1	2018-02-23 03:00:00	4326	4860	-534	31	238	3
1149	1	7	2018-02-23 04:00:00	1014	432	582	29	774	3
1150	1	7	2018-02-23 05:00:00	2232	2268	-36	38	808	3
1151	1	7	2018-02-23 06:00:00	4572	4266	306	27	938	6
1152	1	7	2018-02-23 07:00:00	1772	1782	-10	32	1818	3
1153	1	7	2018-02-23 08:00:00	158	576	-418	43	2870	3
1154	1	2	2018-02-23 09:00:00	5226	4644	582	57	3350	3
1155	1	2	2018-02-23 11:00:00	2616	2538	78	57	658	3
1156	1	2	2018-02-23 12:00:00	2036	1998	38	42	258	3
1157	1	2	2018-02-23 13:00:00	2812	2808	4	34	398	3
1158	1	2	2018-02-23 14:00:00	6468	6372	96	35	428	6
1159	1	2	2018-02-23 15:00:00	8696	8802	-106	55	1886	6
1160	1	2	2018-02-23 16:00:00	8476	8262	214	33	430	3
1161	1	2	2018-02-23 17:00:00	8500	8478	22	40	800	3
1162	1	2	2018-02-23 18:00:00	6432	6372	60	38	342	3
1163	1	2	2018-02-23 19:00:00	9656	9720	-64	58	1516	3
1164	1	2	2018-02-23 20:00:00	8824	8586	238	44	542	3
1165	1	2	2018-02-23 21:00:00	8052	7956	96	40	436	3
1166	1	2	2018-02-23 22:00:00	9688	9612	76	15	3656	6
1167	1	2	2018-02-23 23:00:00	8843	8748	95	1	14340	6
1168	1	2	2018-02-24 00:00:00	2957	3474	-517	204	814	3
1169	1	1	2018-02-24 01:00:00	4826	4158	668	144	1414	3
1170	1	1	2018-02-24 02:00:00	9048	8964	84	125	1228	3
1171	1	1	2018-02-24 03:00:00	7068	6966	102	155	610	3
1172	1	1	2018-02-24 04:00:00	8020	8046	-26	154	1334	3
1173	1	1	2018-02-24 05:00:00	8312	8100	212	99	2850	3
1174	1	1	2018-02-24 06:00:00	7308	7290	18	106	514	6
1175	1	1	2018-02-24 07:00:00	6093	5940	153	141	1258	3
1176	1	1	2018-02-24 08:00:00	8928	8856	72	7	438	3
1177	1	1	2018-02-24 09:00:00	7024	6912	112	183	652	3
1178	1	1	2018-02-24 10:00:00	4494	4932	-438	29	4276	3
1179	1	1	2018-02-24 11:00:00	6388	5778	610	161	536	3
1180	1	1	2018-02-24 12:00:00	6904	6804	100	14	1210	3
1181	1	1	2018-02-24 13:00:00	8784	8748	36	28	278	3
1182	1	1	2018-02-24 14:00:00	9132	9126	6	48	304	6
1183	1	1	2018-02-24 15:00:00	672	1080	-408	58	470	6
1184	1	1	2018-02-24 22:00:00	1452	1026	426	25	362	6
1185	1	1	2018-02-24 23:00:00	6727	6642	85	29	198	6
1186	1	1	2018-02-25 00:00:00	8360	8262	98	44	278	3
1187	1	1	2018-02-25 01:00:00	9172	9126	46	39	208	3
1188	1	1	2018-02-25 02:00:00	8816	8748	68	27	232	3
1189	1	1	2018-02-25 03:00:00	9380	9342	38	29	554	3
1190	1	1	2018-02-25 04:00:00	9340	9288	52	36	238	3
1191	1	1	2018-02-25 05:00:00	9588	9558	30	44	546	3
1192	1	1	2018-02-25 06:00:00	8832	8802	30	86	1466	6
1193	1	1	2018-02-25 07:00:00	9380	9288	92	46	2444	3
1194	1	1	2018-02-25 08:00:00	9440	9396	44	18	438	3
1195	1	1	2018-02-25 09:00:00	9200	9126	74	43	286	3
1196	1	1	2018-02-25 10:00:00	9240	9288	-48	41	368	3
1197	1	1	2018-02-25 11:00:00	6544	6642	-98	41	600	3
1198	1	1	2018-02-25 12:00:00	916	864	52	42	544	3
1199	1	1	2018-02-25 13:00:00	4004	3942	62	53	338	3
1200	1	1	2018-02-25 14:00:00	8443	8262	181	40	850	6
1201	1	1	2018-02-25 15:00:00	7014	6912	102	23	120	6
1202	1	1	2018-02-25 16:00:00	8547	8640	-93	38	382	3
1203	1	1	2018-02-25 17:00:00	7232	7074	158	49	496	3
1204	1	1	2018-02-25 18:00:00	7252	7236	16	63	344	3
1205	1	1	2018-02-25 19:00:00	7920	7830	90	28	176	3
1206	1	1	2018-02-25 20:00:00	7388	7398	-10	24	4212	3
1207	1	1	2018-02-25 21:00:00	7816	7722	94	26	208	3
1208	1	1	2018-02-25 22:00:00	8101	7992	109	47	226	6
1209	1	1	2018-02-25 23:00:00	9212	9180	32	40	570	6
1210	1	1	2018-02-26 00:00:00	9008	8964	44	30	214	3
1211	1	1	2018-02-26 01:00:00	8455	8370	85	27	280	3
1212	1	1	2018-02-26 02:00:00	9544	9558	-14	23	220	3
1213	1	1	2018-02-26 03:00:00	9148	9288	-140	21	486	3
1214	1	1	2018-02-26 04:00:00	9268	9018	250	21	676	3
1215	1	1	2018-02-26 05:00:00	7434	7956	-522	38	510	3
1216	1	3	2018-02-26 07:00:00	678	162	516	129	766	3
1217	1	3	2018-02-26 08:00:00	7387	7236	151	142	1092	3
1218	1	3	2018-02-26 09:00:00	8635	8532	103	115	740	3
1219	1	3	2018-02-26 10:00:00	7272	7236	36	92	1108	3
1220	1	3	2018-02-26 11:00:00	8987	8964	23	89	1090	3
1221	1	3	2018-02-26 12:00:00	7176	7074	102	92	440	3
1222	1	3	2018-02-26 13:00:00	7580	7506	74	97	392	3
1223	1	3	2018-02-26 14:00:00	9592	9504	88	95	464	6
1224	1	3	2018-02-26 15:00:00	9796	9774	22	71	440	6
1225	1	3	2018-02-26 16:00:00	9572	9504	68	112	632	3
1226	1	3	2018-02-26 17:00:00	9568	9504	64	95	710	3
1227	1	3	2018-02-26 18:00:00	8784	8748	36	106	480	3
1228	1	3	2018-02-26 19:00:00	8762	8640	122	92	578	3
1229	1	3	2018-02-26 20:00:00	9467	9450	17	83	826	3
1230	1	3	2018-02-26 21:00:00	9092	9126	-34	52	2548	3
1231	1	3	2018-02-26 22:00:00	8608	8532	76	95	632	6
1232	1	3	2018-02-26 23:00:00	3130	3564	-434	91	654	6
1233	1	1	2018-02-27 00:00:00	8778	8154	624	92	494	7
1234	1	1	2018-02-27 01:00:00	9172	9126	46	119	628	7
1235	1	1	2018-02-27 02:00:00	9420	9450	-30	99	486	7
1236	1	1	2018-02-27 03:00:00	8960	8802	158	99	3384	7
1237	1	1	2018-02-27 04:00:00	9384	9396	-12	201	37726	7
1238	1	1	2018-02-27 05:00:00	1180	1134	46	56	494	3
1239	1	1	2018-02-27 06:00:00	3052	3186	-134	46	820	6
1240	1	1	2018-02-27 16:00:00	804	702	102	52	1926	3
1241	1	1	2018-02-27 17:00:00	8796	8802	-6	64	1344	3
1242	1	1	2018-02-27 18:00:00	5048	4968	80	91	968	3
1243	1	1	2018-02-27 19:00:00	6848	6858	-10	85	1180	7
1244	1	1	2018-02-27 20:00:00	8514	8478	36	137	836	7
1245	1	1	2018-02-27 21:00:00	6768	6642	126	149	442	7
1246	1	1	2018-02-27 22:00:00	8187	8046	141	155	410	14
1247	1	1	2018-02-27 23:00:00	9475	9450	25	130	714	14
1248	1	1	2018-02-28 00:00:00	9564	9504	60	169	464	7
1249	1	1	2018-02-28 01:00:00	8620	8586	34	243	604	7
1250	1	1	2018-02-28 02:00:00	9336	9288	48	147	1082	7
1251	1	1	2018-02-28 03:00:00	8780	8748	32	104	1274	7
1252	1	1	2018-02-28 04:00:00	7596	7506	90	159	476	7
1253	1	1	2018-02-28 05:00:00	6752	6696	56	111	878	7
1254	1	1	2018-02-28 06:00:00	9284	9234	50	48	494	14
1255	1	1	2018-02-28 07:00:00	8156	8100	56	59	598	7
1256	1	1	2018-02-28 08:00:00	9560	9504	56	51	1094	7
1257	1	1	2018-02-28 09:00:00	9404	9288	116	50	282	7
1258	1	1	2018-02-28 10:00:00	7479	7452	27	71	846	7
1259	1	1	2018-02-28 11:00:00	10164	10044	120	73	794	7
1260	1	1	2018-02-28 12:00:00	8816	8802	14	58	376	7
1261	1	1	2018-02-28 13:00:00	8144	8046	98	93	504	7
1262	1	1	2018-02-28 14:00:00	9912	9882	30	79	674	14
1263	1	1	2018-02-28 15:00:00	9464	9342	122	75	662	14
1264	1	1	2018-02-28 16:00:00	9148	9234	-86	60	750	7
1265	1	1	2018-02-28 17:00:00	9060	8910	150	30	40392	7
1266	1	1	2018-02-28 18:00:00	8606	8640	-34	37	624	7
1267	1	1	2018-02-28 19:00:00	3516	3564	-48	34	29166	7
1268	1	1	2018-03-01 06:00:00	3068	2808	260	3	4496	14
1269	1	1	2018-03-01 07:00:00	5257	5400	-143	17	980	7
1270	1	1	2018-03-01 08:00:00	0	126	-126	18	322	7
1271	1	1	2018-03-01 09:00:00	5814	5292	522	35	462	7
1272	1	1	2018-03-01 10:00:00	9707	9504	203	37	560	7
1273	1	1	2018-03-01 11:00:00	9620	9612	8	31	672	7
1274	1	1	2018-03-01 12:00:00	10071	10044	27	20	116840	7
1275	1	1	2018-03-01 13:00:00	8324	8190	134	23	452	7
1276	1	1	2018-03-01 14:00:00	3930	4428	-498	31	670	14
1277	2	12	2018-01-02 10:00:00	4474	3996	478	16	260	5
1278	2	12	2018-01-02 11:00:00	9608	9396	212	29	484	5
1279	2	12	2018-01-02 12:00:00	10840	10746	94	18	146	5
1280	2	12	2018-01-02 13:00:00	10076	10098	-22	52	294	5
1281	2	12	2018-01-02 14:00:00	10007	9990	17	56	382	10
1282	2	12	2018-01-02 15:00:00	9928	9828	100	43	372	15
1283	2	12	2018-01-02 16:00:00	10260	10098	162	28	298	8
1284	2	12	2018-01-02 17:00:00	11024	10962	62	14	38	8
1285	2	12	2018-01-02 18:00:00	9632	9558	74	49	492	8
1286	2	12	2018-01-02 19:00:00	10476	10368	108	35	224	8
1287	2	12	2018-01-02 20:00:00	10400	10368	32	19	232	8
1288	2	12	2018-01-02 21:00:00	10452	10422	30	20	246	8
1289	2	12	2018-01-02 22:00:00	9747	9666	81	37	432	16
1290	2	12	2018-01-02 23:00:00	10380	10314	66	29	228	16
1291	2	12	2018-01-03 00:00:00	9776	9666	110	29	472	8
1292	2	12	2018-01-03 01:00:00	9232	9180	52	74	650	8
1293	2	12	2018-01-03 02:00:00	9872	9882	-10	58	290	8
1294	2	12	2018-01-03 03:00:00	9264	9180	84	62	634	8
1295	2	12	2018-01-03 04:00:00	1304	1332	-28	18	3050	8
1296	2	2	2018-01-03 04:00:00	1304	1332	-28	18	3050	8
1297	2	2	2018-01-03 05:00:00	10288	10152	136	81	276	8
1298	2	2	2018-01-03 06:00:00	5239	5292	-53	16	2990	16
1299	2	2	2018-01-03 07:00:00	6496	6426	70	21	392	8
1300	2	2	2018-01-03 08:00:00	9823	9828	-5	23	430	8
1301	2	2	2018-01-03 09:00:00	9296	9270	26	66	648	8
1302	2	2	2018-01-03 10:00:00	5856	5670	186	38	1652	8
1303	2	2	2018-01-03 11:00:00	9712	9666	46	28	458	8
1304	2	2	2018-01-03 12:00:00	10056	10098	-42	44	338	8
1305	2	2	2018-01-03 13:00:00	8024	7884	140	41	1034	8
1306	2	2	2018-01-03 14:00:00	9562	9558	4	32	474	16
1307	2	2	2018-01-03 15:00:00	10388	10260	128	34	258	16
1308	2	2	2018-01-03 16:00:00	10380	10314	66	64	252	8
1309	2	2	2018-01-03 17:00:00	9464	9450	14	21	508	8
1310	2	2	2018-01-03 18:00:00	4134	3996	138	44	2272	8
1311	2	2	2018-01-03 19:00:00	5912	5832	80	1	3866	8
1312	2	2	2018-01-03 20:00:00	5844	5832	12	17	3322	8
1313	2	2	2018-01-03 21:00:00	10183	10206	-23	20	172	8
1314	2	2	2018-01-03 22:00:00	10272	10260	12	33	230	16
1315	2	2	2018-01-03 23:00:00	10032	9936	96	42	264	16
1316	2	2	2018-01-04 00:00:00	8572	8478	94	33	362	8
1317	2	2	2018-01-04 01:00:00	10136	10044	92	35	874	8
1318	2	2	2018-01-04 02:00:00	8567	8532	35	37	356	8
1319	2	2	2018-01-04 03:00:00	10331	10260	71	43	850	8
1320	2	2	2018-01-04 04:00:00	9960	9882	78	45	192	8
1321	2	2	2018-01-04 05:00:00	10532	10584	-52	45	400	8
1322	2	2	2018-01-04 06:00:00	10620	10476	144	26	210	16
1323	2	2	2018-01-04 07:00:00	9154	9126	28	23	182	8
1324	2	2	2018-01-04 08:00:00	10076	10044	32	28	606	8
1325	2	2	2018-01-04 09:00:00	10296	10260	36	28	272	8
1326	2	2	2018-01-04 10:00:00	9768	9666	102	29	458	8
1327	2	2	2018-01-04 11:00:00	9536	9558	-22	32	3260	8
1328	2	2	2018-01-04 12:00:00	7762	8154	-392	31	322	8
1329	2	2	2018-01-04 13:00:00	3522	2970	552	28	382	8
1330	2	2	2018-01-04 14:00:00	9892	9828	64	22	3840	16
1331	2	2	2018-01-04 15:00:00	5144	5022	122	45	714	16
1332	2	2	2018-01-04 16:00:00	2914	2808	106	35	544	4
1333	2	2	2018-01-04 17:00:00	9268	9234	34	71	846	4
1334	2	2	2018-01-04 18:00:00	8464	8478	-14	29	352	4
1335	2	2	2018-01-04 19:00:00	10139	10044	95	65	474	4
1336	2	2	2018-01-04 20:00:00	9536	9504	32	49	1074	4
1337	2	2	2018-01-04 21:00:00	7904	7884	20	53	1130	4
1338	2	2	2018-01-04 22:00:00	7868	7776	92	32	290	8
1339	2	2	2018-01-04 23:00:00	9948	9882	66	43	396	8
1340	2	2	2018-01-05 00:00:00	9888	9828	60	47	374	4
1341	2	2	2018-01-05 01:00:00	10358	10260	98	27	174	4
1342	2	2	2018-01-05 02:00:00	10210	10152	58	44	462	4
1343	2	2	2018-01-05 03:00:00	9828	9720	108	40	390	4
1344	2	2	2018-01-05 04:00:00	9856	9882	-26	56	458	4
1345	2	2	2018-01-05 05:00:00	9696	9720	-24	66	570	4
1346	2	2	2018-01-05 06:00:00	9340	9072	268	72	498	8
1347	2	2	2018-01-05 07:00:00	9466	9450	16	49	954	4
1348	2	2	2018-01-05 08:00:00	9830	9720	110	1	8330	4
1349	2	2	2018-01-05 09:00:00	8088	7938	150	25	476	4
1350	2	2	2018-01-05 10:00:00	9740	9774	-34	101	444	4
1351	2	2	2018-01-05 11:00:00	9712	9558	154	4	854	4
1352	2	2	2018-01-05 12:00:00	3450	4014	-564	38	454	4
1353	2	4	2018-01-05 13:00:00	3598	3024	574	2	8004	4
1354	2	4	2018-01-05 14:00:00	4924	4860	64	9	206	8
1355	2	4	2018-01-05 15:00:00	4996	4806	190	44	3692	8
1356	2	4	2018-01-05 16:00:00	8016	7884	132	19	350	4
1357	2	4	2018-01-05 17:00:00	4797	4590	207	43	2566	4
1358	2	4	2018-01-05 18:00:00	8776	8694	82	18	604	4
1359	2	4	2018-01-05 19:00:00	6784	6804	-20	37	626	4
1360	2	4	2018-01-05 20:00:00	7800	7614	186	70	1354	4
1361	2	4	2018-01-05 21:00:00	9072	8856	216	73	1038	4
1362	2	4	2018-01-05 22:00:00	1686	2178	-492	54	728	8
1363	2	7	2018-01-06 07:00:00	5534	4914	620	35	472	4
1364	2	7	2018-01-06 08:00:00	10088	10044	44	20	908	4
1365	2	7	2018-01-06 09:00:00	10628	10584	44	31	336	4
1366	2	7	2018-01-06 10:00:00	10372	10314	58	43	154	4
1367	2	7	2018-01-06 11:00:00	10210	10098	112	27	266	4
1368	2	7	2018-01-06 12:00:00	7834	7830	4	41	266	4
1369	2	7	2018-01-06 13:00:00	10764	10638	126	31	1066	4
1370	2	7	2018-01-06 14:00:00	5354	5832	-478	23	350	8
1371	2	7	2018-01-07 06:00:00	2882	2268	614	72	838	12
1372	2	7	2018-01-07 07:00:00	9892	9828	64	10	70	4
1373	2	7	2018-01-07 08:00:00	10512	10476	36	29	390	4
1374	2	7	2018-01-07 09:00:00	10652	10584	68	26	194	4
1375	2	7	2018-01-07 10:00:00	9320	9504	-184	30	148	4
1376	2	7	2018-01-07 11:00:00	10344	10044	300	61	640	4
1377	2	7	2018-01-07 12:00:00	9956	9936	20	32	250	4
1378	2	7	2018-01-07 13:00:00	10412	10260	152	49	292	4
1379	2	7	2018-01-07 14:00:00	10344	10314	30	30	258	8
1380	2	7	2018-01-07 15:00:00	10064	9990	74	27	246	8
1381	2	7	2018-01-07 16:00:00	4190	4716	-526	23	386	4
1382	2	12	2018-01-07 17:00:00	7653	7020	633	46	3170	4
1383	2	12	2018-01-07 18:00:00	7728	7722	6	21	168	4
1384	2	12	2018-01-07 19:00:00	6948	6804	144	46	1082	4
1385	2	12	2018-01-07 20:00:00	10080	10044	36	33	1412	4
1386	2	12	2018-01-07 21:00:00	9248	9234	14	34	476	4
1387	2	12	2018-01-07 22:00:00	10452	10368	84	40	494	8
1388	2	12	2018-01-07 23:00:00	9584	9504	80	23	214	8
1389	2	12	2018-01-08 00:00:00	10696	10638	58	79	496	4
1390	2	12	2018-01-08 01:00:00	10316	10260	56	30	138	4
1391	2	12	2018-01-08 02:00:00	9448	9342	106	25	282	4
1392	2	12	2018-01-08 03:00:00	10160	10152	8	30	534	4
1393	2	12	2018-01-08 04:00:00	10696	10638	58	44	302	4
1394	2	12	2018-01-08 05:00:00	10412	10368	44	31	144	4
1395	2	12	2018-01-08 06:00:00	10848	10800	48	25	236	8
1396	2	12	2018-01-08 07:00:00	10224	10206	18	25	92	4
1397	2	12	2018-01-08 08:00:00	10700	10638	62	33	280	4
1398	2	12	2018-01-08 09:00:00	10688	10584	104	55	142	4
1399	2	12	2018-01-08 10:00:00	10804	10746	58	31	164	4
1400	2	12	2018-01-08 11:00:00	9819	9666	153	30	224	4
1401	2	12	2018-01-08 12:00:00	10836	10800	36	28	312	4
1402	2	12	2018-01-08 13:00:00	10472	10422	50	31	106	4
1403	2	12	2018-01-08 14:00:00	10915	10800	115	22	208	8
1404	2	12	2018-01-08 15:00:00	9918	9882	36	26	116	8
1405	2	12	2018-01-08 16:00:00	2746	3294	-548	27	382	4
1406	2	12	2018-01-08 17:00:00	4674	4050	624	13	4246	4
1407	2	12	2018-01-08 18:00:00	9900	9882	18	50	1802	4
1408	2	12	2018-01-08 19:00:00	8668	8586	82	50	466	4
1409	2	12	2018-01-08 20:00:00	8995	8910	85	65	528	4
1410	2	12	2018-01-08 21:00:00	4752	4698	54	68	236	4
1411	2	12	2018-01-08 22:00:00	8948	8910	38	54	280	8
1412	2	12	2018-01-08 23:00:00	10564	10530	34	63	802	8
1413	2	12	2018-01-09 00:00:00	10256	10152	104	42	612	4
1414	2	12	2018-01-09 01:00:00	10488	10476	12	40	584	4
1415	2	12	2018-01-09 02:00:00	9520	9396	124	28	364	4
1416	2	12	2018-01-09 03:00:00	6596	6588	8	59	908	4
1417	2	12	2018-01-09 04:00:00	8344	8262	82	42	994	4
1418	2	12	2018-01-09 05:00:00	9935	9882	53	24	1340	4
1419	2	12	2018-01-09 06:00:00	6172	6102	70	37	560	11
1420	2	12	2018-01-09 07:00:00	9240	9234	6	58	690	3
1421	2	12	2018-01-09 08:00:00	9584	9558	26	73	596	3
1422	2	12	2018-01-09 09:00:00	8116	8208	-92	42	1190	3
1423	2	12	2018-01-09 10:00:00	8056	7830	226	23	2010	3
1424	2	12	2018-01-09 11:00:00	10416	10422	-6	38	370	3
1425	2	12	2018-01-09 12:00:00	10684	10530	154	47	3302	3
1426	2	12	2018-01-09 13:00:00	9317	9288	29	16	286	3
1427	2	12	2018-01-09 14:00:00	8916	8856	60	35	322	6
1428	2	12	2018-01-09 15:00:00	10308	10206	102	59	588	6
1429	2	12	2018-01-09 16:00:00	8644	8694	-50	42	458	3
1430	2	12	2018-01-09 17:00:00	7628	7344	284	71	922	3
1431	2	12	2018-01-09 18:00:00	9159	9126	33	70	680	3
1432	2	12	2018-01-09 19:00:00	8470	8982	-512	33	704	3
1433	2	2	2018-01-09 21:00:00	8434	7884	550	36	642	3
1434	2	2	2018-01-09 22:00:00	9368	9234	134	53	558	6
1435	2	2	2018-01-09 23:00:00	9110	9072	38	72	724	6
1436	2	2	2018-01-10 00:00:00	8396	8370	26	61	730	3
1437	2	2	2018-01-10 01:00:00	8296	8262	34	53	674	3
1438	2	2	2018-01-10 02:00:00	9796	9666	130	35	392	3
1439	2	2	2018-01-10 03:00:00	9976	9936	40	62	512	3
1440	2	2	2018-01-10 04:00:00	8014	8046	-32	52	656	3
1441	2	2	2018-01-10 05:00:00	9716	9612	104	36	1538	3
1442	2	2	2018-01-10 06:00:00	9428	9342	86	63	650	6
1443	2	2	2018-01-10 07:00:00	9398	9288	110	65	724	3
1444	2	2	2018-01-10 08:00:00	6613	6588	25	80	868	3
1445	2	2	2018-01-10 09:00:00	8331	8262	69	65	792	3
1446	2	2	2018-01-10 10:00:00	10264	10206	58	57	1110	3
1447	2	2	2018-01-10 11:00:00	7116	7128	-12	27	1340	3
1448	2	2	2018-01-10 12:00:00	9096	9018	78	77	656	3
1449	2	2	2018-01-10 13:00:00	10055	9936	119	79	714	3
1450	2	2	2018-01-10 14:00:00	9793	9720	73	57	538	6
1451	2	2	2018-01-10 15:00:00	4571	4752	-181	88	1254	6
1452	2	2	2018-01-10 16:00:00	8852	8532	320	53	1110	3
1453	2	2	2018-01-10 17:00:00	8780	8694	86	47	2094	3
1454	2	2	2018-01-10 18:00:00	9872	9936	-64	64	1042	3
1455	2	2	2018-01-10 19:00:00	10500	10368	132	44	1094	3
1456	2	2	2018-01-10 20:00:00	9740	9666	74	52	4720	3
1457	2	2	2018-01-10 21:00:00	9712	9666	46	9	858	3
1458	2	2	2018-01-10 22:00:00	9220	9180	40	82	682	6
1459	2	2	2018-01-10 23:00:00	10460	10422	38	93	438	6
1460	2	2	2018-01-11 00:00:00	9724	9666	58	50	3756	3
1461	2	2	2018-01-11 01:00:00	7896	7830	66	43	156	3
1462	2	2	2018-01-11 02:00:00	9836	9828	8	68	674	3
1463	2	2	2018-01-11 03:00:00	10408	10260	148	89	472	3
1464	2	2	2018-01-11 04:00:00	9932	10044	-112	102	570	3
1465	2	2	2018-01-11 05:00:00	9130	9018	112	64	2152	3
1466	2	2	2018-01-11 06:00:00	9920	9774	146	123	1106	6
1467	2	2	2018-01-11 07:00:00	5671	6174	-503	69	2636	7
1468	2	4	2018-01-11 09:00:00	8132	7830	302	68	2080	7
1469	2	4	2018-01-11 10:00:00	10020	9882	138	102	1670	7
1470	2	4	2018-01-11 11:00:00	9036	9126	-90	53	2814	7
1471	2	4	2018-01-11 12:00:00	5585	5868	-283	69	1830	7
1472	2	12	2018-01-11 13:00:00	1510	1026	484	46	1330	7
1473	2	12	2018-01-11 14:00:00	9852	9774	78	67	1082	14
1474	2	12	2018-01-11 15:00:00	10428	10260	168	40	576	14
1475	2	12	2018-01-11 16:00:00	9376	9396	-20	53	2010	7
1476	2	12	2018-01-11 17:00:00	8120	8100	20	72	1916	7
1477	2	12	2018-01-11 18:00:00	9900	9720	180	92	1508	7
1478	2	12	2018-01-11 19:00:00	9398	9396	2	116	4960	7
1479	2	12	2018-01-11 20:00:00	7784	7830	-46	2	412	7
1480	2	12	2018-01-11 21:00:00	8830	8586	244	37	532	7
1481	2	12	2018-01-11 22:00:00	9060	8964	96	45	538	14
1482	2	12	2018-01-11 23:00:00	8784	8856	-72	63	1222	14
1483	2	12	2018-01-12 00:00:00	3772	3726	46	103	934	7
1484	2	12	2018-01-12 01:00:00	5980	5778	202	60	1426	7
1485	2	12	2018-01-12 02:00:00	9980	9936	44	69	1148	7
1486	2	12	2018-01-12 03:00:00	9968	10098	-130	51	794	7
1487	2	12	2018-01-12 04:00:00	9480	9234	246	46	2236	7
1488	2	12	2018-01-12 05:00:00	10296	10260	36	43	796	7
1489	2	12	2018-01-12 06:00:00	10340	10314	26	61	1140	14
1490	2	12	2018-01-12 07:00:00	10172	10152	20	43	1632	7
1491	2	12	2018-01-12 08:00:00	10116	9990	126	39	664	7
1492	2	12	2018-01-12 09:00:00	9076	8964	112	60	542	7
1493	2	12	2018-01-12 10:00:00	1476	1512	-36	33	4314	7
1494	2	12	2018-01-12 11:00:00	4692	4698	-6	14	8406	7
1495	2	12	2018-01-12 12:00:00	1987	2160	-173	30	2194	7
1496	2	12	2018-01-12 17:00:00	5664	5400	264	2	18356	7
1497	2	12	2018-01-12 18:00:00	10188	10098	90	35	1002	7
1498	2	12	2018-01-12 19:00:00	9932	9828	104	35	314	7
1499	2	12	2018-01-12 20:00:00	6556	6570	-14	40	1016	7
1500	2	12	2018-01-12 21:00:00	9076	9558	-482	66	882	7
1501	2	12	2018-01-14 07:00:00	670	108	562	59	538	7
1502	2	12	2018-01-14 08:00:00	9147	9018	129	23	266	7
1503	2	12	2018-01-14 09:00:00	6824	6858	-34	1	62	7
1504	2	12	2018-01-14 10:00:00	10019	9936	83	29	592	7
1505	2	12	2018-01-14 11:00:00	10319	10314	5	29	1372	7
1506	2	12	2018-01-14 12:00:00	9756	9558	198	38	366	7
1507	2	12	2018-01-14 13:00:00	9614	9558	56	39	252	7
1508	2	12	2018-01-14 14:00:00	10644	10584	60	34	490	14
1509	2	12	2018-01-14 15:00:00	9047	8964	83	90	422	14
1510	2	12	2018-01-14 16:00:00	9206	9234	-28	30	240	7
1511	2	12	2018-01-14 17:00:00	9023	8856	167	32	596	7
1512	2	12	2018-01-14 18:00:00	8675	8586	89	63	650	7
1513	2	12	2018-01-14 19:00:00	9244	9180	64	72	626	7
1514	2	12	2018-01-14 20:00:00	7708	7776	-68	58	824	7
1515	2	12	2018-01-14 21:00:00	8162	7938	224	71	564	7
1516	2	12	2018-01-14 22:00:00	8909	8910	-1	49	1214	14
1517	2	12	2018-01-14 23:00:00	9780	9558	222	66	824	14
1518	2	12	2018-01-15 00:00:00	5554	5562	-8	88	696	7
1519	2	12	2018-01-15 01:00:00	1711	1512	199	51	482	3
1520	2	12	2018-01-15 02:00:00	8952	8856	96	50	3726	3
1521	2	12	2018-01-15 03:00:00	9971	9936	35	21	1390	3
1522	2	12	2018-01-15 04:00:00	9332	9234	98	32	354	3
1523	2	12	2018-01-15 05:00:00	9052	9018	34	40	592	3
1524	2	12	2018-01-15 06:00:00	10172	10098	74	39	376	6
1525	2	12	2018-01-15 07:00:00	10108	10044	64	61	676	3
1526	2	12	2018-01-15 08:00:00	2154	2718	-564	64	294	3
1527	2	2	2018-01-15 09:00:00	5874	5238	636	59	326	8
1528	2	2	2018-01-15 10:00:00	10220	10260	-40	38	4372	8
1529	2	2	2018-01-15 11:00:00	9560	9450	110	23	232	8
1530	2	2	2018-01-15 12:00:00	10016	10044	-28	34	266	8
1531	2	2	2018-01-15 13:00:00	9932	9828	104	39	520	8
1532	2	2	2018-01-15 14:00:00	9601	9612	-11	38	354	16
1533	2	2	2018-01-15 15:00:00	9476	9342	134	53	418	16
1534	2	2	2018-01-15 16:00:00	9580	9612	-32	48	490	8
1535	2	2	2018-01-15 17:00:00	8656	8478	178	43	550	8
1536	2	2	2018-01-15 18:00:00	9171	9126	45	91	494	8
1537	2	2	2018-01-15 19:00:00	8648	8694	-46	74	812	8
1538	2	2	2018-01-15 20:00:00	3364	3294	70	54	632	8
1539	2	2	2018-01-15 21:00:00	4376	4482	-106	80	808	8
1540	2	2	2018-01-15 22:00:00	4708	4536	172	40	4010	16
1541	2	2	2018-01-15 23:00:00	4704	4644	60	44	664	20
1542	2	2	2018-01-16 00:00:00	8328	8262	66	27	2368	7
1543	2	2	2018-01-16 01:00:00	10444	10368	76	50	1820	3
1544	2	2	2018-01-16 02:00:00	10056	9990	66	61	892	3
1545	2	2	2018-01-16 03:00:00	10168	10098	70	46	242	3
1546	2	2	2018-01-16 04:00:00	9860	9828	32	46	356	3
1547	2	2	2018-01-16 05:00:00	9301	9180	121	52	316	3
1548	2	2	2018-01-16 06:00:00	9587	9558	29	99	394	6
1549	2	2	2018-01-16 07:00:00	8512	8532	-20	61	604	3
1550	2	2	2018-01-16 08:00:00	8158	7992	166	91	494	3
1551	2	2	2018-01-16 09:00:00	7026	6912	114	72	982	3
1552	2	2	2018-01-16 10:00:00	8740	8856	-116	99	836	3
1553	2	2	2018-01-16 11:00:00	8190	7992	198	73	1338	3
1554	2	2	2018-01-16 12:00:00	7007	6858	149	68	672	3
1555	2	2	2018-01-16 13:00:00	6495	6480	15	57	990	3
1556	2	2	2018-01-16 14:00:00	10008	9882	126	56	1320	6
1557	2	2	2018-01-16 15:00:00	8948	9072	-124	69	1476	6
1558	2	2	2018-01-16 16:00:00	9420	9180	240	51	314	3
1559	2	2	2018-01-16 17:00:00	9323	9288	35	69	726	3
1560	2	2	2018-01-16 18:00:00	7853	7884	-31	87	496	3
1561	2	2	2018-01-16 19:00:00	5850	6210	-360	81	586	3
1562	2	12	2018-01-16 20:00:00	1182	594	588	66	1196	3
1563	2	12	2018-01-16 21:00:00	8864	8802	62	79	1564	3
1564	2	12	2018-01-16 22:00:00	8424	8424	0	8	3184	11
1565	2	12	2018-01-16 23:00:00	7684	7614	70	62	740	8
1566	2	12	2018-01-17 00:00:00	9664	9612	52	75	814	4
1567	2	12	2018-01-17 01:00:00	10522	10368	154	151	1068	4
1568	2	12	2018-01-17 02:00:00	9439	9396	43	24	474	4
1569	2	12	2018-01-17 03:00:00	20	54	-34	89	1182	4
1570	2	12	2018-01-17 07:00:00	5576	5508	68	62	17412	4
1571	2	12	2018-01-17 08:00:00	10024	9936	88	45	236	4
1572	2	12	2018-01-17 09:00:00	10532	10476	56	106	542	4
1573	2	12	2018-01-17 10:00:00	10316	10368	-52	77	532	4
1574	2	12	2018-01-17 11:00:00	9864	9666	198	53	552	4
1575	2	12	2018-01-17 12:00:00	10596	10584	12	78	492	4
1576	2	12	2018-01-17 13:00:00	10240	10098	142	103	830	4
1577	2	12	2018-01-17 14:00:00	10511	10368	143	64	360	8
1578	2	12	2018-01-17 15:00:00	7891	7938	-47	93	878	8
1579	2	12	2018-01-17 16:00:00	8845	8586	259	51	1222	4
1580	2	12	2018-01-17 17:00:00	10128	9990	138	89	730	4
1581	2	12	2018-01-17 18:00:00	10316	10206	110	59	468	4
1582	2	12	2018-01-17 19:00:00	9964	9882	82	70	312	4
1583	2	12	2018-01-17 20:00:00	6028	5886	142	68	870	4
1584	2	12	2018-01-17 21:00:00	10300	10206	94	99	736	4
1585	2	12	2018-01-17 22:00:00	6136	6156	-20	57	506	8
1586	2	12	2018-01-17 23:00:00	308	108	200	52	530	8
1587	2	12	2018-01-18 00:00:00	540	648	-108	9	4198	4
1588	2	12	2018-01-18 01:00:00	9819	9828	-9	6	2666	4
1589	2	12	2018-01-18 02:00:00	8204	8154	50	31	394	4
1590	2	12	2018-01-18 03:00:00	8697	8640	57	110	1044	4
1591	2	12	2018-01-18 04:00:00	1136	1188	-52	33	630	4
1592	2	10	2018-01-18 04:00:00	1136	1188	-52	33	630	4
1593	2	10	2018-01-18 05:00:00	9616	9342	274	11	3204	4
1594	2	10	2018-01-18 06:00:00	6364	6210	154	39	464	8
1595	2	10	2018-01-18 15:00:00	6416	6480	-64	1	7234	8
1596	2	10	2018-01-18 16:00:00	10136	9936	200	46	772	4
1597	2	10	2018-01-18 17:00:00	10292	10206	86	39	712	4
1598	2	10	2018-01-18 18:00:00	6736	6696	40	37	410	4
1599	2	10	2018-01-18 19:00:00	9384	9288	96	39	694	4
1600	2	10	2018-01-18 20:00:00	10199	10098	101	42	302	4
1601	2	10	2018-01-18 21:00:00	10308	10152	156	70	754	4
1602	2	10	2018-01-18 22:00:00	9876	9828	48	63	494	8
1603	2	10	2018-01-18 23:00:00	10022	9936	86	55	604	8
1604	2	10	2018-01-19 00:00:00	9992	9936	56	59	788	4
1605	2	10	2018-01-19 01:00:00	8444	8316	128	45	458	4
1606	2	10	2018-01-19 02:00:00	8088	7992	96	43	244	4
1607	2	10	2018-01-19 03:00:00	10368	10314	54	36	2256	4
1608	2	10	2018-01-19 04:00:00	10508	10422	86	16	1166	4
1609	2	10	2018-01-19 05:00:00	10248	10152	96	64	526	4
1610	2	10	2018-01-19 06:00:00	7382	7884	-502	17	634	8
1611	2	12	2018-01-19 07:00:00	1930	1350	580	85	1212	4
1612	2	12	2018-01-19 08:00:00	9975	9882	93	46	1568	9
1613	2	12	2018-01-19 09:00:00	10365	10314	51	48	830	5
1614	2	12	2018-01-19 10:00:00	10209	10098	111	138	676	5
1615	2	12	2018-01-19 11:00:00	8660	8586	74	27	212	5
1616	2	12	2018-01-19 12:00:00	10122	10098	24	59	398	5
1617	2	12	2018-01-19 13:00:00	10378	10314	64	25	1070	5
1618	2	12	2018-01-19 14:00:00	9128	9072	56	36	1622	13
1619	2	12	2018-01-19 15:00:00	10535	10422	113	74	1148	3
1620	2	12	2018-01-19 16:00:00	10052	9936	116	41	418	3
1621	2	12	2018-01-19 17:00:00	9808	9720	88	55	916	3
1622	2	12	2018-01-19 18:00:00	8923	8910	13	126	792	3
1623	2	12	2018-01-19 19:00:00	8491	8370	121	41	914	3
1624	2	12	2018-01-19 20:00:00	7575	7506	69	83	944	3
1625	2	12	2018-01-19 21:00:00	2592	2538	54	86	344	3
1626	2	12	2018-01-19 22:00:00	7886	7830	56	16	3244	6
1627	2	12	2018-01-19 23:00:00	10068	10044	24	24	318	6
1628	2	12	2018-01-20 00:00:00	10452	10476	-24	41	28534	3
1629	2	12	2018-01-20 01:00:00	10748	10584	164	25	1082	3
1630	2	12	2018-01-20 02:00:00	2006	2376	-370	42	320	3
1631	2	12	2018-01-20 03:00:00	10319	9828	491	36	200	3
1632	2	12	2018-01-20 04:00:00	7052	7050	2	34	118	3
1633	2	12	2018-01-20 05:00:00	9972	9936	36	17	3012	3
1634	2	12	2018-01-20 06:00:00	10088	10044	44	34	1324	6
1635	2	12	2018-01-20 07:00:00	7845	7776	69	21	1542	3
1636	2	12	2018-01-20 08:00:00	9605	9558	47	82	1180	3
1637	2	12	2018-01-20 09:00:00	10300	10368	-68	103	654	3
1638	2	12	2018-01-20 10:00:00	9422	9288	134	81	422	3
1639	2	12	2018-01-20 11:00:00	10410	10368	42	61	598	3
1640	2	12	2018-01-20 12:00:00	9372	9234	138	79	1136	3
1641	2	12	2018-01-20 13:00:00	9412	9288	124	63	702	3
1642	2	12	2018-01-20 14:00:00	10296	10368	-72	63	780	6
1643	2	12	2018-01-20 15:00:00	10368	10260	108	22	594	6
1644	2	12	2018-01-20 16:00:00	10556	10422	134	65	58114	3
1645	2	12	2018-01-20 17:00:00	9900	9990	-90	16	226	3
1646	2	12	2018-01-20 18:00:00	9476	9396	80	28	254	3
1647	2	12	2018-01-20 19:00:00	10675	10530	145	29	218	3
1648	2	12	2018-01-20 20:00:00	9768	9774	-6	40	374	3
1649	2	12	2018-01-20 21:00:00	9430	9396	34	33	536	3
1650	2	12	2018-01-20 22:00:00	10695	10638	57	22	196	6
1651	2	12	2018-01-20 23:00:00	10416	10314	102	35	486	6
1652	2	12	2018-01-21 00:00:00	3281	3294	-13	26	494	3
1653	2	12	2018-01-21 00:00:00	3281	3294	-13	26	494	3
1654	2	12	2018-01-21 01:00:00	9592	9504	88	21	176	3
1655	2	12	2018-01-21 02:00:00	10455	10368	87	20	218	3
1656	2	12	2018-01-21 03:00:00	9286	9180	106	20	2488	3
1657	2	12	2018-01-21 04:00:00	9448	9396	52	27	526	3
1658	2	12	2018-01-21 05:00:00	10152	10152	0	39	196	3
1659	2	12	2018-01-21 06:00:00	10480	10368	112	32	536	6
1660	2	12	2018-01-21 07:00:00	9224	9126	98	4	132	3
1661	2	12	2018-01-21 08:00:00	10092	10098	-6	54	2042	3
1662	2	12	2018-01-21 09:00:00	9396	9396	0	35	712	3
1663	2	12	2018-01-21 10:00:00	10132	9990	142	51	784	3
1664	2	12	2018-01-21 11:00:00	10488	10368	120	31	606	3
1665	2	12	2018-01-21 12:00:00	9784	9666	118	45	746	3
1666	2	12	2018-01-21 13:00:00	10298	10260	38	69	1406	3
1667	2	12	2018-01-21 14:00:00	8759	8802	-43	42	698	6
1668	2	12	2018-01-21 15:00:00	8452	8262	190	21	5936	6
1669	2	12	2018-01-21 16:00:00	7392	7398	-6	3	26	3
1670	2	12	2018-01-21 17:00:00	9185	9126	59	50	988	3
1671	2	12	2018-01-21 18:00:00	1458	1908	-450	46	484	4
1672	2	12	2018-01-21 19:00:00	6432	5832	600	18	322	4
1673	2	12	2018-01-21 20:00:00	10283	10260	23	43	570	4
1674	2	12	2018-01-21 21:00:00	9664	9612	52	39	504	4
1675	2	12	2018-01-21 22:00:00	8963	8856	107	106	1164	8
1676	2	12	2018-01-21 23:00:00	9052	9018	34	59	644	8
1677	2	12	2018-01-22 00:00:00	10600	10530	70	49	326	4
1678	2	12	2018-01-22 01:00:00	10860	10746	114	34	608	4
1679	2	12	2018-01-22 02:00:00	10848	10800	48	41	210	4
1680	2	12	2018-01-22 03:00:00	9832	9882	-50	50	396	4
1681	2	12	2018-01-22 04:00:00	10040	9990	50	21	70	4
1682	2	12	2018-01-22 05:00:00	10064	9936	128	38	358	4
1683	2	12	2018-01-22 06:00:00	8227	8154	73	62	402	8
1684	2	12	2018-01-22 07:00:00	8786	8802	-16	59	1146	4
1685	2	12	2018-01-22 08:00:00	9580	9450	130	35	704	4
1686	2	12	2018-01-22 09:00:00	9702	9612	90	44	268	4
1687	2	12	2018-01-22 10:00:00	9860	9828	32	33	1822	4
1688	2	12	2018-01-22 11:00:00	9324	9288	36	53	628	4
1689	2	12	2018-01-22 12:00:00	9576	9504	72	78	688	4
1690	2	12	2018-01-22 13:00:00	8844	8748	96	53	2470	4
1691	2	12	2018-01-22 14:00:00	9908	9990	-82	55	1144	8
1692	2	12	2018-01-22 15:00:00	7114	6966	148	24	178	8
1693	2	12	2018-01-22 16:00:00	8822	8802	20	25	496	4
1694	2	12	2018-01-22 17:00:00	8768	8748	20	29	5082	4
1695	2	12	2018-01-22 18:00:00	8831	8748	83	40	744	4
1696	2	12	2018-01-22 19:00:00	2582	3060	-478	25	776	4
1697	2	12	2018-01-22 21:00:00	1140	864	276	29	230	4
1698	2	12	2018-01-22 22:00:00	8696	8748	-52	12	438	6
1699	2	12	2018-01-22 23:00:00	10779	10692	87	64	748	6
1700	2	12	2018-01-23 00:00:00	4012	3888	124	20	150	3
1701	2	12	2018-01-23 01:00:00	6636	6696	-60	37	3298	3
1702	2	12	2018-01-23 02:00:00	9464	9342	122	39	494	3
1703	2	12	2018-01-23 03:00:00	8892	8910	-18	37	520	3
1704	2	12	2018-01-23 04:00:00	7812	7668	144	80	702	3
1705	2	12	2018-01-23 05:00:00	7876	7884	-8	29	1266	3
1706	2	12	2018-01-23 06:00:00	10054	9936	118	84	864	6
1707	2	12	2018-01-23 07:00:00	9437	9342	95	35	400	3
1708	2	12	2018-01-23 08:00:00	8240	8262	-22	36	4450	3
1709	2	12	2018-01-23 09:00:00	4556	4590	-34	33	490	3
1710	2	12	2018-01-23 10:00:00	4942	4752	190	25	932	3
1711	2	12	2018-01-23 11:00:00	1388	1404	-16	21	2640	3
1712	2	12	2018-01-23 12:00:00	8943	8856	87	20	1676	3
1713	2	12	2018-01-23 13:00:00	9461	9342	119	63	3450	3
1714	2	12	2018-01-23 14:00:00	10032	9990	42	3	15754	6
1715	2	12	2018-01-23 15:00:00	9892	9828	64	78	362	6
1716	2	12	2018-01-23 16:00:00	8952	8856	96	35	2014	3
1717	2	12	2018-01-23 17:00:00	7992	7938	54	25	302	3
1718	2	12	2018-01-23 18:00:00	6556	6534	22	49	606	3
1719	2	12	2018-01-23 19:00:00	8979	8964	15	101	476	3
1720	2	12	2018-01-23 20:00:00	9684	9558	126	58	586	3
1721	2	12	2018-01-23 21:00:00	9279	9234	45	33	368	3
1722	2	12	2018-01-23 22:00:00	10043	10044	-1	33	576	6
1723	2	12	2018-01-23 23:00:00	9440	9342	98	24	302	6
1724	2	12	2018-01-24 00:00:00	10232	10152	80	20	474	3
1725	2	12	2018-01-24 01:00:00	9676	9612	64	38	816	3
1726	2	12	2018-01-24 02:00:00	8852	8748	104	31	3876	3
1727	2	12	2018-01-24 03:00:00	6646	7218	-572	22	840	3
1728	2	12	2018-01-24 04:00:00	715	270	445	40	710	3
1729	2	12	2018-01-24 05:00:00	8892	8694	198	23	166	3
1730	2	12	2018-01-24 06:00:00	10580	10530	50	47	370	6
1731	2	12	2018-01-24 07:00:00	10180	10098	82	29	214	3
1732	2	12	2018-01-24 08:00:00	10336	10314	22	73	674	3
1733	2	12	2018-01-24 09:00:00	8964	8910	54	31	7770	3
1734	2	12	2018-01-24 10:00:00	4759	4752	7	83	1374	3
1735	2	12	2018-01-24 11:00:00	80	0	80	78	3512	3
1736	2	12	2018-01-24 12:00:00	3664	3402	262	43	252	3
1737	2	12	2018-01-24 13:00:00	3063	3078	-15	68	524	3
1738	2	12	2018-01-24 14:00:00	6132	5994	138	82	822	6
1739	2	12	2018-01-24 15:00:00	10279	10152	127	56	284	10
1740	2	12	2018-01-24 16:00:00	10147	9936	211	72	944	4
1741	2	12	2018-01-24 17:00:00	9083	9126	-43	2	4218	4
1742	2	12	2018-01-24 18:00:00	10367	10206	161	26	848	4
1743	2	12	2018-01-24 19:00:00	4834	4914	-80	55	392	4
1744	2	12	2018-01-24 20:00:00	701	378	323	31	438	4
1745	2	12	2018-01-24 21:00:00	172	162	10	70	448	4
1746	2	12	2018-01-24 22:00:00	184	108	76	47	1726	8
1747	2	12	2018-01-24 23:00:00	112	108	4	41	518	8
1748	2	12	2018-01-25 00:00:00	5255	5184	71	32	706	4
1749	2	12	2018-01-25 01:00:00	9568	9396	172	28	604	4
1750	2	12	2018-01-25 02:00:00	8984	8856	128	18	310	4
1751	2	12	2018-01-25 03:00:00	9724	9612	112	28	402	4
1752	2	12	2018-01-25 04:00:00	9652	9612	40	63	706	4
1753	2	12	2018-01-25 05:00:00	9908	9774	134	35	1728	4
1754	2	12	2018-01-25 06:00:00	9016	8964	52	48	704	8
1755	2	12	2018-01-25 07:00:00	5648	5562	86	11	3780	4
1756	2	12	2018-01-25 08:00:00	8940	8964	-24	47	682	4
1757	2	12	2018-01-25 09:00:00	2800	2646	154	44	732	4
1758	2	12	2018-01-25 10:00:00	5732	5724	8	23	428	4
1759	2	12	2018-01-25 11:00:00	9040	8856	184	20	2508	4
1760	2	12	2018-01-25 12:00:00	9728	9666	62	44	1324	4
1761	2	12	2018-01-25 13:00:00	3536	3510	26	29	3320	4
1762	2	12	2018-01-25 14:00:00	6722	6696	26	25	492	8
1763	2	12	2018-01-25 15:00:00	5078	5526	-448	35	440	8
1764	2	10	2018-01-25 16:00:00	5422	4806	616	44	288	4
1765	2	10	2018-01-25 17:00:00	9840	9666	174	25	1024	4
1766	2	10	2018-01-25 18:00:00	9916	9882	34	48	524	4
1767	2	10	2018-01-25 19:00:00	8100	7884	216	23	394	4
1768	2	10	2018-01-25 20:00:00	9380	9288	92	51	1642	4
1769	2	10	2018-01-25 21:00:00	9912	9774	138	91	872	4
1770	2	10	2018-01-25 22:00:00	6020	5994	26	2	4304	8
1771	2	10	2018-01-25 23:00:00	7874	8262	-388	31	1030	8
1772	2	10	2018-01-26 00:00:00	0	36	-36	35	938	4
1773	2	4	2018-01-26 01:00:00	6058	5530	528	39	598	4
1774	2	4	2018-01-26 02:00:00	8088	7912	176	36	550	4
1775	2	4	2018-01-26 03:00:00	9212	9180	32	26	662	4
1776	2	4	2018-01-26 04:00:00	9016	8911	105	32	730	4
1777	2	4	2018-01-26 05:00:00	9360	9342	18	63	836	4
1778	2	4	2018-01-26 06:00:00	8132	7993	139	57	852	10
1779	2	4	2018-01-26 07:00:00	8711	8587	124	22	2680	3
1780	2	4	2018-01-26 08:00:00	8872	8802	70	23	328	3
1781	2	4	2018-01-26 09:00:00	2964	3529	-565	23	142	3
1782	2	2	2018-01-26 10:00:00	9278	8640	638	34	1038	3
1783	2	2	2018-01-26 10:00:00	9278	8640	638	34	1038	3
1784	2	15	2018-01-26 10:00:00	9278	8640	638	34	1038	3
1785	2	2	2018-01-26 11:00:00	10656	10638	18	43	1882	3
1786	2	2	2018-01-26 11:00:00	10656	10638	18	43	1882	3
1787	2	15	2018-01-26 11:00:00	10656	10638	18	43	1882	3
1788	2	2	2018-01-26 12:00:00	7920	7884	36	60	444	3
1789	2	2	2018-01-26 12:00:00	7920	7884	36	60	444	3
1790	2	15	2018-01-26 12:00:00	7920	7884	36	60	444	3
1791	2	2	2018-01-26 13:00:00	5292	5238	54	46	510	3
1792	2	2	2018-01-26 13:00:00	5292	5238	54	46	510	3
1793	2	15	2018-01-26 13:00:00	5292	5238	54	46	510	3
1794	2	2	2018-01-26 14:00:00	9848	9720	128	77	582	6
1795	2	2	2018-01-26 14:00:00	9848	9720	128	77	582	6
1796	2	15	2018-01-26 14:00:00	9848	9720	128	77	582	6
1797	2	2	2018-01-26 15:00:00	9452	9504	-52	41	278	6
1798	2	2	2018-01-26 15:00:00	9452	9504	-52	41	278	6
1799	2	15	2018-01-26 15:00:00	9452	9504	-52	41	278	6
1800	2	2	2018-01-26 16:00:00	9294	9180	114	39	420	3
1801	2	2	2018-01-26 16:00:00	9294	9180	114	39	420	3
1802	2	15	2018-01-26 16:00:00	9294	9180	114	39	420	3
1803	2	2	2018-01-26 17:00:00	10275	10152	123	43	376	3
1804	2	2	2018-01-26 17:00:00	10275	10152	123	43	376	3
1805	2	15	2018-01-26 17:00:00	10275	10152	123	43	376	3
1806	2	2	2018-01-26 18:00:00	9820	9720	100	83	408	3
1807	2	2	2018-01-26 18:00:00	9820	9720	100	83	408	3
1808	2	15	2018-01-26 18:00:00	9820	9720	100	83	408	3
1809	2	2	2018-01-26 19:00:00	9940	9882	58	5	10	3
1810	2	2	2018-01-26 19:00:00	9940	9882	58	5	10	3
1811	2	15	2018-01-26 19:00:00	9940	9882	58	5	10	3
1812	2	2	2018-01-26 20:00:00	9824	9666	158	42	694	3
1813	2	2	2018-01-26 20:00:00	9824	9666	158	42	694	3
1814	2	15	2018-01-26 20:00:00	9824	9666	158	42	694	3
1815	2	2	2018-01-26 21:00:00	1992	1998	-6	53	1016	3
1816	2	2	2018-01-26 21:00:00	1992	1998	-6	53	1016	3
1817	2	15	2018-01-26 21:00:00	1992	1998	-6	53	1016	3
1818	2	2	2018-01-27 07:00:00	3944	3972	-28	79	766	8
1819	2	2	2018-01-27 07:00:00	3944	3972	-28	79	766	8
1820	2	15	2018-01-27 07:00:00	3944	3972	-28	79	766	8
1821	2	2	2018-01-27 08:00:00	9120	8964	156	33	548	3
1822	2	2	2018-01-27 08:00:00	9120	8964	156	33	548	3
1823	2	15	2018-01-27 08:00:00	9120	8964	156	33	548	3
1824	2	2	2018-01-27 09:00:00	8720	8640	80	38	476	3
1825	2	2	2018-01-27 09:00:00	8720	8640	80	38	476	3
1826	2	15	2018-01-27 09:00:00	8720	8640	80	38	476	3
1827	2	2	2018-01-27 10:00:00	9260	9180	80	81	798	3
1828	2	2	2018-01-27 10:00:00	9260	9180	80	81	798	3
1829	2	15	2018-01-27 10:00:00	9260	9180	80	81	798	3
1830	2	2	2018-01-27 11:00:00	9760	9774	-14	44	734	3
1831	2	2	2018-01-27 11:00:00	9760	9774	-14	44	734	3
1832	2	15	2018-01-27 11:00:00	9760	9774	-14	44	734	3
1833	2	2	2018-01-27 12:00:00	8548	8424	124	36	58530	3
1834	2	2	2018-01-27 12:00:00	8548	8424	124	36	58530	3
1835	2	15	2018-01-27 12:00:00	8548	8424	124	36	58530	3
1836	2	2	2018-01-27 13:00:00	8819	8748	71	58	690	3
1837	2	2	2018-01-27 13:00:00	8819	8748	71	58	690	3
1838	2	15	2018-01-27 13:00:00	8819	8748	71	58	690	3
1839	2	2	2018-01-27 14:00:00	3222	3492	-270	39	584	6
1840	2	2	2018-01-27 14:00:00	3222	3492	-270	39	584	6
1841	2	15	2018-01-27 14:00:00	3222	3492	-270	39	584	6
1842	2	2	2018-01-28 07:00:00	3334	2700	634	41	366	3
1843	2	2	2018-01-28 08:00:00	7064	7020	44	53	380	3
1844	2	2	2018-01-28 09:00:00	8716	8586	130	61	190	3
1845	2	2	2018-01-28 10:00:00	7791	7776	15	53	348	3
1846	2	2	2018-01-28 11:00:00	8916	8856	60	65	836	3
1847	2	2	2018-01-28 12:00:00	8844	8802	42	64	498	3
1848	2	2	2018-01-28 13:00:00	9784	9720	64	63	1328	3
1849	2	2	2018-01-28 14:00:00	8752	8748	4	64	2838	6
1850	2	2	2018-01-28 15:00:00	6840	7020	-180	68	488	6
1851	2	2	2018-01-28 16:00:00	9516	9234	282	60	602	7
1852	2	2	2018-01-28 17:00:00	10440	10368	72	61	704	4
1853	2	2	2018-01-28 18:00:00	10412	10368	44	53	490	4
1854	2	2	2018-01-28 19:00:00	10147	10044	103	108	406	7
1855	2	2	2018-01-28 20:00:00	10008	9990	18	43	488	3
1856	2	2	2018-01-28 21:00:00	10128	10152	-24	54	302	3
1857	2	2	2018-01-28 22:00:00	10072	9990	82	65	822	6
1858	2	2	2018-01-28 23:00:00	8560	8424	136	55	1116	6
1859	2	2	2018-01-29 00:00:00	8672	8694	-22	102	746	3
1860	2	2	2018-01-29 01:00:00	8452	8370	82	33	630	3
1861	2	2	2018-01-29 02:00:00	8607	8478	129	42	426	3
1862	2	2	2018-01-29 03:00:00	8360	8208	152	55	588	3
1863	2	2	2018-01-29 04:00:00	8507	8370	137	47	1156	3
1864	2	2	2018-01-29 05:00:00	8221	8208	13	55	2704	3
1865	2	2	2018-01-29 06:00:00	9284	9180	104	56	910	7
1866	2	2	2018-01-29 07:00:00	8456	8316	140	36	1644	2
1867	2	2	2018-01-29 08:00:00	10380	10314	66	53	762	2
1868	2	2	2018-01-29 09:00:00	10095	10098	-3	21	3778	6
1869	2	2	2018-01-29 10:00:00	7972	7920	52	22	464	4
1870	2	2	2018-01-29 11:00:00	9148	9072	76	57	1680	4
1871	2	2	2018-01-29 12:00:00	7203	7236	-33	55	612	4
1872	2	2	2018-01-29 13:00:00	7980	7938	42	6	3486	4
1873	2	2	2018-01-29 14:00:00	7789	8244	-455	24	726	8
1874	2	4	2018-01-29 15:00:00	474	0	474	60	1310	8
1875	2	4	2018-01-29 16:00:00	8556	8370	186	39	546	4
1876	2	4	2018-01-29 17:00:00	10228	10098	130	61	1180	4
1877	2	4	2018-01-29 18:00:00	9328	9234	94	48	1156	4
1878	2	4	2018-01-29 19:00:00	10400	10314	86	53	648	4
1879	2	4	2018-01-29 20:00:00	9992	9936	56	88	868	4
1880	2	4	2018-01-29 21:00:00	9704	9612	92	51	434	4
1881	2	4	2018-01-29 22:00:00	9902	9774	128	83	1032	10
1882	2	4	2018-01-29 23:00:00	934	1494	-560	43	382	6
1883	2	12	2018-01-30 00:00:00	7778	7020	758	60	480	3
1884	2	12	2018-01-30 01:00:00	520	756	-236	78	720	3
1885	2	12	2018-01-30 03:00:00	4531	4158	373	75	650	3
1886	2	12	2018-01-30 04:00:00	9258	8856	402	120	31044	3
1887	2	12	2018-01-30 05:00:00	5758	5508	250	81	354	3
1888	2	12	2018-01-30 06:00:00	7746	7614	132	51	710	6
1889	2	12	2018-01-30 07:00:00	9804	9504	300	38	374	3
1890	2	12	2018-01-30 08:00:00	9584	9558	26	61	676	3
1891	2	12	2018-01-30 09:00:00	8924	8856	68	62	852	3
1892	2	12	2018-01-30 10:00:00	9984	9936	48	20	70	7
1893	2	12	2018-01-30 11:00:00	8924	8856	68	50	772	4
1894	2	12	2018-01-30 12:00:00	8559	8370	189	90	932	4
1895	2	12	2018-01-30 13:00:00	10936	10908	28	28	410	4
1896	2	12	2018-01-30 14:00:00	8775	8694	81	84	928	8
1897	2	12	2018-01-30 15:00:00	9912	9828	84	30	2372	8
1898	2	12	2018-01-30 16:00:00	10204	10098	106	40	660	4
1899	2	12	2018-01-30 17:00:00	9744	9666	78	49	504	4
1900	2	12	2018-01-30 18:00:00	9532	9396	136	44	820	4
1901	2	12	2018-01-30 19:00:00	8440	8532	-92	76	942	4
1902	2	12	2018-01-30 20:00:00	2452	2160	292	51	688	4
1903	2	12	2018-01-30 21:00:00	9680	9612	68	69	1358	4
1904	2	12	2018-01-30 22:00:00	9732	9666	66	55	1622	8
1905	2	12	2018-01-30 23:00:00	6832	6624	208	30	658	7
1906	2	12	2018-01-31 00:00:00	9484	9450	34	41	744	5
1907	2	12	2018-01-31 01:00:00	7800	7668	132	48	644	5
1908	2	12	2018-01-31 02:00:00	8408	8316	92	59	630	5
1909	2	12	2018-01-31 03:00:00	136	216	-80	32	826	5
1910	2	12	2018-01-31 04:00:00	92	54	38	49	1252	5
1911	2	12	2018-01-31 05:00:00	256	54	202	68	3188	5
1912	2	12	2018-01-31 06:00:00	348	378	-30	8	138	10
1913	2	12	2018-01-31 07:00:00	128	54	74	35	3472	5
1914	2	12	2018-01-31 08:00:00	996	702	294	15	240	5
1915	2	12	2018-01-31 09:00:00	8156	7938	218	52	1196	5
1916	2	12	2018-01-31 10:00:00	2391	2376	15	74	3350	5
1917	2	12	2018-01-31 11:00:00	6496	6264	232	41	372	5
1918	2	12	2018-01-31 12:00:00	9316	9180	136	81	1280	5
1919	2	12	2018-01-31 13:00:00	7555	7398	157	70	1904	5
1920	2	12	2018-01-31 14:00:00	9043	8856	187	56	768	10
1921	2	12	2018-01-31 15:00:00	9220	9126	94	66	586	10
1922	2	12	2018-01-31 16:00:00	9292	9126	166	89	942	5
1923	2	12	2018-01-31 17:00:00	9344	9216	128	62	796	5
1924	2	12	2018-01-31 18:00:00	9864	9720	144	45	610	5
1925	2	12	2018-01-31 19:00:00	9348	9234	114	55	720	5
1926	2	12	2018-01-31 20:00:00	8996	8856	140	77	2060	5
1927	2	12	2018-01-31 21:00:00	9559	9504	55	60	884	5
1928	2	12	2018-01-31 22:00:00	9524	9396	128	62	1512	10
1929	2	12	2018-01-31 23:00:00	8520	8532	-12	39	918	10
1930	2	12	2018-02-01 00:00:00	8954	8856	98	31	1994	5
1931	2	12	2018-02-01 01:00:00	2010	1800	210	54	998	5
1932	2	12	2018-02-01 01:00:00	2010	1800	210	54	998	5
1933	2	12	2018-02-01 02:00:00	8588	8694	-106	36	342	5
1934	2	12	2018-02-01 03:00:00	8315	8316	-1	59	458	5
1935	2	12	2018-02-01 04:00:00	8356	8370	-14	90	3492	5
1936	2	12	2018-02-01 05:00:00	8672	8478	194	31	1190	5
1937	2	12	2018-02-01 06:00:00	9863	9720	143	48	2188	10
1938	2	12	2018-02-01 07:00:00	8984	8910	74	28	412	5
1939	2	12	2018-02-01 08:00:00	8632	8532	100	45	1720	5
1940	2	12	2018-02-01 09:00:00	9228	9234	-6	44	530	5
1941	2	12	2018-02-01 10:00:00	7508	7668	-160	41	852	5
1942	2	12	2018-02-01 11:00:00	92	54	38	55	714	5
1943	2	12	2018-02-01 12:00:00	8507	8208	299	48	938	5
1944	2	12	2018-02-01 13:00:00	8948	8964	-16	44	568	5
1945	2	12	2018-02-01 14:00:00	8315	8154	161	42	560	10
1946	2	12	2018-02-01 15:00:00	9615	9558	57	40	274	10
1947	2	12	2018-02-01 16:00:00	9064	9018	46	53	724	5
1948	2	12	2018-02-01 17:00:00	10300	10314	-14	56	810	5
1949	2	12	2018-02-01 18:00:00	8876	8802	74	69	372	5
1950	2	12	2018-02-01 19:00:00	8876	8748	128	37	432	5
1951	2	12	2018-02-01 20:00:00	9783	9666	117	25	30246	5
1952	2	12	2018-02-01 21:00:00	10000	10206	-206	44	458	5
1953	2	12	2018-02-01 22:00:00	2099	2052	47	39	650	10
1954	2	12	2018-02-02 06:00:00	3943	3780	163	16	506	10
1955	2	12	2018-02-02 07:00:00	5756	5886	-130	106	11150	5
1956	2	12	2018-02-02 08:00:00	1814	1620	194	37	496	5
1957	2	12	2018-02-02 09:00:00	9811	9720	91	1	3288	5
1958	2	12	2018-02-02 10:00:00	9644	9558	86	15	530	5
1959	2	12	2018-02-02 11:00:00	8644	8802	-158	3	1692	5
1960	2	12	2018-02-02 12:00:00	2474	2268	206	30	278	5
1961	2	12	2018-02-02 13:00:00	10316	10260	56	41	452	5
1962	2	12	2018-02-02 14:00:00	9836	9828	8	38	834	10
1963	2	12	2018-02-02 15:00:00	8580	8370	210	30	4412	10
1964	2	12	2018-02-02 16:00:00	7316	7236	80	20	248	5
1965	2	12	2018-02-02 17:00:00	815	918	-103	67	1586	5
1966	2	12	2018-02-02 18:00:00	6088	5994	94	61	360	5
1967	2	12	2018-02-02 19:00:00	9896	9774	122	60	568	5
1968	2	12	2018-02-02 20:00:00	9350	9504	-154	43	580	5
1969	2	12	2018-02-02 21:00:00	9379	9126	253	57	698	5
1970	2	12	2018-02-02 22:00:00	9010	8910	100	63	628	10
1971	2	12	2018-02-02 23:00:00	9387	9342	45	58	414	10
1972	2	12	2018-02-03 00:00:00	9608	9612	-4	50	216	5
1973	2	12	2018-02-03 01:00:00	10532	10422	110	74	788	5
1974	2	12	2018-02-03 02:00:00	8972	9018	-46	63	202	5
1975	2	12	2018-02-03 03:00:00	10212	9990	222	93	572	5
1976	2	12	2018-02-03 04:00:00	9320	9126	194	72	336	5
1977	2	12	2018-02-03 05:00:00	10135	9990	145	69	450	5
1978	2	12	2018-02-03 06:00:00	9659	9558	101	34	3010	10
1979	2	12	2018-02-03 07:00:00	2810	3330	-520	45	502	5
1980	2	12	2018-02-03 08:00:00	8162	7398	764	78	448	5
1981	2	12	2018-02-03 09:00:00	9559	9396	163	44	2732	5
1982	2	12	2018-02-03 10:00:00	7436	7344	92	17	2500	5
1983	2	12	2018-02-03 11:00:00	2606	3078	-472	41	254	5
1984	2	12	2018-02-03 12:00:00	6350	5724	626	67	374	5
1985	2	12	2018-02-03 13:00:00	9875	9774	101	75	538	5
1986	2	12	2018-02-03 14:00:00	9408	9288	120	75	436	10
1987	2	12	2018-02-03 15:00:00	9812	9936	-124	90	554	10
1988	2	12	2018-02-03 16:00:00	9500	9288	212	73	1288	5
1989	2	12	2018-02-03 17:00:00	6820	6750	70	74	626	5
1990	2	12	2018-02-03 18:00:00	9188	9126	62	79	348	5
1991	2	12	2018-02-03 19:00:00	10076	9936	140	83	1116	5
1992	2	12	2018-02-03 20:00:00	7649	7560	89	49	744	5
1993	2	12	2018-02-03 21:00:00	8676	8640	36	43	286	5
1994	2	12	2018-02-03 22:00:00	10288	10152	136	58	430	10
1995	2	12	2018-02-03 23:00:00	9832	9666	166	45	546	10
1996	2	12	2018-02-04 00:00:00	9476	9342	134	67	428	5
1997	2	12	2018-02-04 01:00:00	9931	9828	103	39	534	5
1998	2	12	2018-02-04 02:00:00	9268	9234	34	32	454	5
1999	2	12	2018-02-04 03:00:00	9748	9612	136	46	612	5
2000	2	12	2018-02-04 04:00:00	9261	9072	189	48	1632	5
2001	2	12	2018-02-04 05:00:00	6094	5940	154	53	2086	5
2002	2	12	2018-02-04 06:00:00	6866	6750	116	38	1638	10
2003	2	12	2018-02-04 07:00:00	3765	3618	147	30	186	5
2004	2	12	2018-02-04 08:00:00	10524	10422	102	36	354	5
2005	2	12	2018-02-04 09:00:00	10192	9990	202	49	496	5
2006	2	12	2018-02-04 10:00:00	9460	9450	10	31	236	5
2007	2	12	2018-02-04 11:00:00	10500	10368	132	44	380	5
2008	2	12	2018-02-04 12:00:00	9872	9936	-64	42	756	5
2009	2	12	2018-02-04 13:00:00	8884	8694	190	43	806	5
2010	2	12	2018-02-04 14:00:00	8620	8532	88	41	3358	10
2011	2	12	2018-02-04 15:00:00	5706	6210	-504	23	118	10
2012	2	12	2018-02-04 16:00:00	5834	5238	596	45	648	5
2013	2	12	2018-02-04 17:00:00	9055	8964	91	51	624	5
2014	2	12	2018-02-04 18:00:00	9195	9126	69	43	1060	5
2015	2	12	2018-02-04 19:00:00	7900	7830	70	50	360	5
2016	2	12	2018-02-04 20:00:00	10028	10044	-16	58	384	5
2017	2	12	2018-02-04 21:00:00	9906	9720	186	53	146	5
2018	2	12	2018-02-04 22:00:00	10583	10530	53	66	334	10
2019	2	12	2018-02-04 23:00:00	10076	9990	86	56	684	10
2020	2	12	2018-02-05 00:00:00	9788	9774	14	71	288	5
2021	2	12	2018-02-05 01:00:00	9388	9288	100	58	396	5
2022	2	12	2018-02-05 02:00:00	9916	9882	34	58	360	5
2023	2	12	2018-02-05 03:00:00	9936	9828	108	95	484	5
2024	2	12	2018-02-05 04:00:00	9588	9558	30	59	350	5
2025	2	12	2018-02-05 05:00:00	9920	9828	92	55	284	5
2026	2	12	2018-02-05 06:00:00	10172	10098	74	60	1184	10
2027	2	12	2018-02-05 07:00:00	7580	7506	74	34	1844	5
2028	2	12	2018-02-05 08:00:00	5791	5724	67	43	640	5
2029	2	12	2018-02-05 09:00:00	8643	8532	111	41	792	5
2030	2	12	2018-02-05 10:00:00	8672	8532	140	41	250	5
2031	2	12	2018-02-05 11:00:00	10359	10260	99	48	946	5
2032	2	12	2018-02-05 12:00:00	8334	8424	-90	9	4410	5
2033	2	12	2018-02-05 13:00:00	170	612	-442	18	1204	5
2034	2	12	2018-02-05 14:00:00	6501	5832	669	33	684	10
2035	2	12	2018-02-05 15:00:00	6940	6804	136	61	502	10
2036	2	12	2018-02-05 16:00:00	9380	9342	38	63	622	5
2037	2	12	2018-02-05 17:00:00	9132	8910	222	31	236	5
2038	2	12	2018-02-05 18:00:00	10252	10152	100	18	2766	5
2039	2	12	2018-02-05 19:00:00	2550	2430	120	53	236	5
2040	2	2	2018-02-05 19:00:00	2550	2430	120	53	236	5
2041	2	2	2018-02-05 20:00:00	10436	10422	14	38	534	5
2042	2	2	2018-02-05 21:00:00	9435	9342	93	71	448	5
2043	2	2	2018-02-05 22:00:00	9680	9666	14	32	362	10
2044	2	2	2018-02-05 23:00:00	10234	10260	-26	64	384	10
2045	2	2	2018-02-06 00:00:00	9804	9666	138	62	776	5
2046	2	2	2018-02-06 01:00:00	8844	8910	-66	64	1874	5
2047	2	2	2018-02-06 02:00:00	8748	8748	0	22	786	5
2048	2	2	2018-02-06 03:00:00	5172	4914	258	75	376	5
2049	2	2	2018-02-06 04:00:00	9984	9882	102	102	608	5
2050	2	2	2018-02-06 05:00:00	9342	9288	54	81	482	5
2051	2	2	2018-02-06 06:00:00	9412	9396	16	74	494	10
2052	2	2	2018-02-06 07:00:00	10532	10422	110	67	1026	5
2053	2	2	2018-02-06 08:00:00	7028	7020	8	90	692	5
2054	2	2	2018-02-06 09:00:00	8908	8802	106	97	500	5
2055	2	2	2018-02-06 10:00:00	9500	9450	50	71	1194	5
2056	2	2	2018-02-06 11:00:00	7376	7344	32	87	622	5
2057	2	2	2018-02-06 12:00:00	9424	9504	-80	109	932	5
2058	2	2	2018-02-06 13:00:00	8212	7992	220	58	864	5
2059	2	2	2018-02-06 14:00:00	8144	7938	206	66	598	10
2060	2	2	2018-02-06 15:00:00	9240	9180	60	65	260	10
2061	2	2	2018-02-06 16:00:00	10296	10206	90	41	700	9
2062	2	2	2018-02-06 17:00:00	9092	9126	-34	88	300	4
2063	2	2	2018-02-06 18:00:00	10096	9990	106	62	460	4
2064	2	2	2018-02-06 19:00:00	9616	9504	112	68	314	4
2065	2	2	2018-02-06 20:00:00	10098	10098	0	63	298	4
2066	2	2	2018-02-06 21:00:00	10296	10206	90	63	302	4
2067	2	2	2018-02-06 22:00:00	10158	10044	114	64	332	8
2068	2	2	2018-02-06 23:00:00	10100	10044	56	42	230	8
2069	2	2	2018-02-07 00:00:00	9970	9990	-20	69	632	4
2070	2	2	2018-02-07 01:00:00	9224	9000	224	44	398	4
2071	2	2	2018-02-07 02:00:00	9912	9828	84	42	3148	4
2072	2	2	2018-02-07 03:00:00	7454	7956	-502	26	1316	4
2073	2	6	2018-02-07 04:00:00	402	0	402	39	1744	4
2074	2	6	2018-02-07 05:00:00	5446	5076	370	45	1124	4
2075	2	6	2018-02-07 06:00:00	7496	7344	152	49	4612	8
2076	2	6	2018-02-07 07:00:00	6035	6462	-427	7	62	4
2077	2	12	2018-02-07 08:00:00	1630	1026	604	57	626	4
2078	2	12	2018-02-07 09:00:00	9095	9018	77	37	1860	4
2079	2	12	2018-02-07 10:00:00	9816	9666	150	81	1090	4
2080	2	12	2018-02-07 11:00:00	9158	9126	32	65	952	4
2081	2	12	2018-02-07 12:00:00	10051	9936	115	53	1048	4
2082	2	12	2018-02-07 13:00:00	9560	9450	110	87	2132	4
2083	2	12	2018-02-07 14:00:00	9724	9612	112	39	596	8
2084	2	12	2018-02-07 15:00:00	6392	6318	74	62	790	8
2085	2	12	2018-02-07 16:00:00	6000	5994	6	60	812	4
2086	2	12	2018-02-07 17:00:00	8531	8316	215	56	740	4
2087	2	12	2018-02-07 18:00:00	4844	4806	38	91	942	4
2088	2	12	2018-02-07 19:00:00	6896	6750	146	68	906	4
2089	2	12	2018-02-07 20:00:00	3387	3456	-69	72	830	4
2090	2	12	2018-02-07 21:00:00	219	108	111	83	1528	4
2091	2	12	2018-02-07 22:00:00	7959	7776	183	53	688	8
2092	2	12	2018-02-07 23:00:00	9935	9882	53	73	1044	8
2093	2	12	2018-02-08 00:00:00	9233	9072	161	52	2006	4
2094	2	12	2018-02-08 01:00:00	8816	8640	176	102	1076	4
2095	2	12	2018-02-08 02:00:00	8150	7992	158	68	1652	4
2096	2	12	2018-02-08 03:00:00	10264	10206	58	40	826	4
2097	2	12	2018-02-08 04:00:00	3850	3834	16	40	824	4
2098	2	12	2018-02-08 05:00:00	8880	8964	-84	59	724	4
2099	2	12	2018-02-08 06:00:00	8936	8748	188	49	684	8
2100	2	12	2018-02-08 07:00:00	9011	8964	47	54	1592	4
2101	2	12	2018-02-08 08:00:00	9256	9288	-32	54	1572	4
2102	2	12	2018-02-08 09:00:00	7654	7668	-14	28	1858	4
2103	2	12	2018-02-08 10:00:00	7056	6858	198	56	1082	4
2104	2	12	2018-02-08 11:00:00	7448	7344	104	45	860	4
2105	2	12	2018-02-08 12:00:00	6439	6534	-95	40	1544	4
2106	2	12	2018-02-08 13:00:00	7956	7884	72	35	2516	4
2107	2	12	2018-02-08 14:00:00	3720	3564	156	2	3110	8
2108	2	12	2018-02-08 15:00:00	9358	9342	16	20	928	8
2109	2	12	2018-02-08 16:00:00	8371	8316	55	25	406	4
2110	2	12	2018-02-08 17:00:00	7287	7236	51	18	286	4
2111	2	12	2018-02-08 18:00:00	2010	2574	-564	34	234	4
2112	2	7	2018-02-08 19:00:00	2614	2106	508	67	1926	4
2113	2	7	2018-02-08 20:00:00	10056	9882	174	101	2310	4
2114	2	7	2018-02-08 21:00:00	10152	10098	54	19	224	4
2115	2	7	2018-02-08 22:00:00	1391	1512	-121	38	630	8
2116	2	7	2018-02-08 23:00:00	3297	3078	219	30	1020	8
2117	2	7	2018-02-09 00:00:00	9232	9180	52	31	364	4
2118	2	7	2018-02-09 01:00:00	8605	8532	73	21	844	7
2119	2	7	2018-02-09 02:00:00	9432	9450	-18	12	218	7
2120	2	7	2018-02-09 03:00:00	10556	10476	80	63	10908	7
2121	2	7	2018-02-09 04:00:00	9431	9288	143	1	9372	7
2122	2	7	2018-02-09 05:00:00	7112	7128	-16	4	7782	7
2123	2	7	2018-02-09 06:00:00	0	54	-54	6	156	14
2124	2	7	2018-02-09 08:00:00	196	162	34	37	592	7
2125	2	7	2018-02-09 10:00:00	1048	1026	22	41	2398	7
2126	2	7	2018-02-09 11:00:00	8524	8478	46	52	1098	7
2127	2	7	2018-02-09 12:00:00	3668	3672	-4	54	1294	7
2128	2	7	2018-02-09 13:00:00	7335	7236	99	80	1574	7
2129	2	7	2018-02-09 14:00:00	7256	7182	74	62	536	14
2130	2	7	2018-02-09 15:00:00	6192	6102	90	93	590	14
2131	2	7	2018-02-09 16:00:00	9464	9558	-94	97	930	7
2132	2	7	2018-02-09 17:00:00	9132	8964	168	102	650	7
2133	2	7	2018-02-09 18:00:00	8576	8640	-64	132	756	7
2134	2	7	2018-02-09 19:00:00	8800	8640	160	92	574	7
2135	2	7	2018-02-09 20:00:00	8599	8586	13	106	520	7
2136	2	7	2018-02-09 21:00:00	9545	9504	41	96	476	7
2137	2	7	2018-02-09 22:00:00	9247	9126	121	97	818	14
2138	2	7	2018-02-09 23:00:00	9564	9558	6	103	644	14
2139	2	7	2018-02-10 00:00:00	8607	8532	75	101	722	7
2140	2	7	2018-02-10 01:00:00	8976	8910	66	92	546	7
2141	2	7	2018-02-10 02:00:00	8768	8802	-34	111	692	7
2142	2	7	2018-02-10 03:00:00	9368	9234	134	102	1158	7
2143	2	7	2018-02-10 04:00:00	8832	8802	30	12	3682	7
2144	2	7	2018-02-10 05:00:00	9004	9018	-14	43	1360	7
2145	2	7	2018-02-10 06:00:00	196	612	-416	95	600	14
2146	2	10	2018-02-10 07:00:00	4616	4104	512	99	832	7
2147	2	10	2018-02-10 08:00:00	9276	9126	150	119	574	7
2148	2	10	2018-02-10 09:00:00	8496	8424	72	105	338	7
2149	2	10	2018-02-10 10:00:00	9000	8910	90	84	582	7
2150	2	10	2018-02-10 11:00:00	9940	9828	112	110	994	7
2151	2	10	2018-02-10 12:00:00	9248	9126	122	103	464	7
2152	2	10	2018-02-10 13:00:00	8140	8154	-14	86	656	7
2153	2	10	2018-02-10 14:00:00	9520	9342	178	86	578	14
2154	2	10	2018-02-10 15:00:00	8780	8748	32	134	622	14
2155	2	10	2018-02-10 16:00:00	9382	9288	94	153	672	7
2156	2	10	2018-02-10 17:00:00	9068	9018	50	81	2852	7
2157	2	10	2018-02-10 18:00:00	8834	8694	140	81	372	7
2158	2	10	2018-02-10 19:00:00	5018	5562	-544	127	880	7
2159	2	12	2018-02-10 20:00:00	7064	6534	530	139	402	7
2160	2	12	2018-02-10 21:00:00	8148	7938	210	127	654	7
2161	2	12	2018-02-10 22:00:00	9768	9774	-6	122	494	14
2162	2	12	2018-02-10 23:00:00	9100	9018	82	80	398	14
2163	2	12	2018-02-11 00:00:00	9448	9396	52	124	434	7
2164	2	12	2018-02-11 01:00:00	9759	9612	147	61	460	7
2165	2	12	2018-02-11 02:00:00	9660	9612	48	51	438	7
2166	2	12	2018-02-11 03:00:00	9608	9558	50	51	392	7
2167	2	12	2018-02-11 04:00:00	9836	9720	116	57	320	7
2168	2	12	2018-02-11 05:00:00	9863	9828	35	59	600	7
2169	2	12	2018-02-11 06:00:00	10159	10044	115	61	538	14
2170	2	12	2018-02-11 07:00:00	9177	9126	51	66	628	7
2171	2	12	2018-02-11 08:00:00	9480	9342	138	81	996	7
2172	2	12	2018-02-11 09:00:00	9339	9342	-3	89	536	7
2173	2	12	2018-02-11 10:00:00	7788	7614	174	70	520	7
2174	2	12	2018-02-11 11:00:00	9482	9396	86	79	740	7
2175	2	12	2018-02-11 12:00:00	9700	9666	34	39	1964	7
2176	2	12	2018-02-11 13:00:00	8576	8478	98	76	452	7
2177	2	12	2018-02-11 14:00:00	5180	4788	392	59	452	14
2178	2	12	2018-02-11 15:00:00	9764	9720	44	87	552	14
2179	2	12	2018-02-11 16:00:00	9592	9504	88	70	644	7
2180	2	12	2018-02-11 17:00:00	9386	9342	44	58	3624	7
2181	2	12	2018-02-11 18:00:00	9056	9072	-16	25	178	7
2182	2	12	2018-02-11 19:00:00	7686	8046	-360	57	550	7
2183	2	12	2018-02-11 20:00:00	2782	2214	568	67	402	7
2184	2	12	2018-02-11 21:00:00	9388	9342	46	144	816	7
2185	2	12	2018-02-11 22:00:00	9940	9828	112	86	512	14
2186	2	12	2018-02-11 23:00:00	8488	8424	64	64	684	14
2187	2	12	2018-02-12 00:00:00	9440	9450	-10	86	508	7
2188	2	12	2018-02-12 01:00:00	8928	8856	72	86	436	7
2189	2	12	2018-02-12 02:00:00	9616	9450	166	75	934	7
2190	2	12	2018-02-12 03:00:00	9744	9720	24	51	868	7
2191	2	12	2018-02-12 04:00:00	8012	7938	74	117	594	7
2192	2	12	2018-02-12 05:00:00	8460	8424	36	6	3108	7
2193	2	12	2018-02-12 06:00:00	9316	9126	190	44	6304	14
2194	2	12	2018-02-12 07:00:00	9960	9882	78	1	13200	10
2195	2	12	2018-02-12 08:00:00	9084	9072	12	46	244	4
2196	2	12	2018-02-12 09:00:00	3532	3726	-194	5	220	4
2197	2	12	2018-02-12 11:00:00	8284	8046	238	67	748	4
2198	2	12	2018-02-12 12:00:00	10288	10260	28	67	764	4
2199	2	12	2018-02-12 13:00:00	9848	9720	128	72	1214	4
2200	2	12	2018-02-12 14:00:00	9764	9828	-64	71	334	8
2201	2	12	2018-02-12 15:00:00	8806	8586	220	88	758	11
2202	2	12	2018-02-12 16:00:00	8026	7992	34	77	584	3
2203	2	12	2018-02-12 17:00:00	10154	10098	56	95	330	3
2204	2	12	2018-02-12 18:00:00	9984	10044	-60	116	588	3
2205	2	12	2018-02-12 19:00:00	9568	9396	172	112	1322	3
2206	2	12	2018-02-12 20:00:00	7552	7452	100	45	2146	3
2207	2	12	2018-02-12 21:00:00	8808	8640	168	82	1222	3
2208	2	12	2018-02-12 22:00:00	9600	9504	96	92	644	6
2209	2	12	2018-02-12 23:00:00	7216	7128	88	66	3022	6
2210	2	12	2018-02-13 00:00:00	9456	9342	114	38	712	3
2211	2	12	2018-02-13 01:00:00	8736	8694	42	45	594	3
2212	2	12	2018-02-13 02:00:00	9418	9342	76	2	3282	3
2213	2	12	2018-02-13 03:00:00	9466	9234	232	34	1134	3
2214	2	12	2018-02-13 04:00:00	1722	2286	-564	58	668	3
2215	2	12	2018-02-13 07:00:00	4656	4050	606	58	714	3
2216	2	12	2018-02-13 08:00:00	8800	8640	160	81	502	3
2217	2	12	2018-02-13 09:00:00	10268	10206	62	50	272	3
2218	2	12	2018-02-13 10:00:00	8860	8694	166	61	690	3
2219	2	12	2018-02-13 11:00:00	9539	9450	89	34	3302	3
2220	2	12	2018-02-13 12:00:00	10144	9936	208	55	392	3
2221	2	12	2018-02-13 13:00:00	8884	8802	82	33	420	3
2222	2	12	2018-02-13 14:00:00	2878	3420	-542	39	418	6
2223	2	12	2018-02-13 15:00:00	7598	6966	632	23	950	6
2224	2	12	2018-02-13 16:00:00	9892	9882	10	46	560	3
2225	2	12	2018-02-13 17:00:00	9743	9594	149	36	404	3
2226	2	12	2018-02-13 18:00:00	8160	8100	60	30	410	3
2227	2	12	2018-02-13 19:00:00	9408	9288	120	26	1068	3
2228	2	12	2018-02-13 20:00:00	9900	9720	180	28	368	3
2229	2	12	2018-02-13 21:00:00	9847	9720	127	37	496	3
2230	2	12	2018-02-13 22:00:00	8624	8640	-16	86	840	6
2231	2	12	2018-02-13 23:00:00	9076	8964	112	24	2920	6
2232	2	12	2018-02-14 00:00:00	9560	9450	110	68	920	3
2233	2	12	2018-02-14 01:00:00	8524	8478	46	48	912	3
2234	2	12	2018-02-14 02:00:00	1927	1836	91	47	316	3
2235	2	12	2018-02-14 02:00:00	1927	1836	91	47	316	3
2236	2	12	2018-02-14 03:00:00	8180	8154	26	23	226	3
2237	2	12	2018-02-14 04:00:00	8224	8154	70	42	866	3
2238	2	12	2018-02-14 05:00:00	10104	9936	168	61	700	3
2239	2	12	2018-02-14 06:00:00	2944	3078	-134	54	840	6
2240	2	12	2018-02-14 14:00:00	60	162	-102	52	478	6
2241	2	12	2018-02-14 15:00:00	3612	3402	210	30	1160	8
2242	2	12	2018-02-14 16:00:00	6580	6534	46	42	226	2
2243	2	12	2018-02-14 17:00:00	4576	4482	94	34	9272	2
2244	2	12	2018-02-14 18:00:00	9075	8748	327	67	428	2
2245	2	12	2018-02-14 19:00:00	9972	9828	144	45	850	2
2246	2	12	2018-02-14 20:00:00	10144	10044	100	55	594	2
2247	2	12	2018-02-14 21:00:00	5520	5454	66	94	1808	2
2248	2	12	2018-02-14 22:00:00	9980	9882	98	71	622	4
2249	2	12	2018-02-14 23:00:00	8452	8424	28	60	3428	4
2250	2	12	2018-02-15 00:00:00	9256	9126	130	41	252	2
2251	2	12	2018-02-15 01:00:00	5472	5400	72	26	2016	5
2252	2	12	2018-02-15 02:00:00	2878	3222	-344	64	2182	5
2253	2	12	2018-02-15 03:00:00	7632	7020	612	90	962	5
2254	2	12	2018-02-15 04:00:00	5092	5184	-92	27	3170	5
2255	2	12	2018-02-15 05:00:00	5428	5346	82	68	578	5
2256	2	12	2018-02-15 06:00:00	7000	6804	196	82	612	10
2257	2	12	2018-02-15 07:00:00	2380	2214	166	59	604	5
2258	2	12	2018-02-15 08:00:00	7936	7830	106	58	2092	5
2259	2	12	2018-02-15 09:00:00	9332	9234	98	71	356	5
2260	2	12	2018-02-15 10:00:00	9159	9072	87	29	268	5
2261	2	12	2018-02-15 11:00:00	4756	4698	58	74	374	5
2262	2	12	2018-02-15 12:00:00	8944	8856	88	61	216	5
2263	2	12	2018-02-15 13:00:00	10208	10152	56	84	404	5
2264	2	12	2018-02-15 14:00:00	9728	9612	116	69	380	10
2265	2	12	2018-02-15 15:00:00	10420	10314	106	68	386	10
2266	2	12	2018-02-15 16:00:00	9812	9774	38	87	252	5
2267	2	12	2018-02-15 17:00:00	9952	9828	124	42	276	5
2268	2	12	2018-02-15 18:00:00	10040	10044	-4	38	276	5
2269	2	12	2018-02-15 19:00:00	10107	9936	171	40	664	5
2270	2	12	2018-02-15 20:00:00	10368	10314	54	41	592	5
2271	2	12	2018-02-15 21:00:00	10108	10044	64	29	2590	5
2272	2	12	2018-02-15 22:00:00	9587	9504	83	46	662	10
2273	2	12	2018-02-15 23:00:00	9004	8910	94	82	3870	4
2274	2	12	2018-02-16 00:00:00	3348	3348	0	15	138	5
2275	2	12	2018-02-16 01:00:00	8576	8586	-10	88	458	3
2276	2	12	2018-02-16 02:00:00	6010	6462	-452	92	1548	3
2277	2	12	2018-02-16 03:00:00	3590	3186	404	107	450	3
2278	2	12	2018-02-16 04:00:00	9701	9504	197	103	390	3
2279	2	12	2018-02-16 05:00:00	7088	7182	-94	5	226	3
2280	2	12	2018-02-16 06:00:00	8831	8586	245	73	1500	6
2281	2	12	2018-02-16 07:00:00	9785	9720	65	38	1200	3
2282	2	12	2018-02-16 08:00:00	7972	7938	34	142	362	3
2283	2	12	2018-02-16 09:00:00	9348	9288	60	107	904	3
2284	2	12	2018-02-16 10:00:00	9952	9882	70	137	442	3
2285	2	12	2018-02-16 11:00:00	9856	9828	28	130	526	3
2286	2	12	2018-02-16 12:00:00	8336	8316	20	122	416	3
2287	2	12	2018-02-16 13:00:00	9571	9504	67	75	348	3
2288	2	12	2018-02-16 14:00:00	9376	9342	34	58	268	6
2289	2	12	2018-02-16 15:00:00	9648	9612	36	94	214	6
2290	2	12	2018-02-16 16:00:00	10136	10044	92	136	410	3
2291	2	12	2018-02-16 17:00:00	10208	10206	2	114	572	3
2292	2	12	2018-02-16 18:00:00	10448	10368	80	92	634	3
2293	2	12	2018-02-16 19:00:00	9784	9666	118	128	634	3
2294	2	12	2018-02-16 20:00:00	9276	9234	42	161	532	3
2295	2	12	2018-02-16 21:00:00	9104	9072	32	120	986	3
2296	2	12	2018-02-16 22:00:00	9076	9018	58	165	692	6
2297	2	12	2018-02-16 23:00:00	9471	9396	75	145	1806	6
2298	2	12	2018-02-17 00:00:00	7831	7776	55	158	732	7
2299	2	12	2018-02-17 01:00:00	8604	8640	-36	140	962	7
2300	2	12	2018-02-17 02:00:00	6112	5994	118	179	852	7
2301	2	12	2018-02-17 03:00:00	8286	8262	24	116	2964	7
2302	2	12	2018-02-17 04:00:00	7836	7776	60	43	208	7
2303	2	12	2018-02-17 05:00:00	8160	8100	60	106	2254	7
2304	2	12	2018-02-17 06:00:00	8651	9180	-529	63	278	14
2305	2	12	2018-02-17 07:00:00	3706	3078	628	79	2060	7
2306	2	12	2018-02-17 08:00:00	8663	8640	23	130	694	7
2307	2	12	2018-02-17 09:00:00	5528	5454	74	130	732	7
2308	2	12	2018-02-17 10:00:00	4792	4806	-14	153	532	7
2309	2	12	2018-02-17 11:00:00	8592	8586	6	124	1048	7
2310	2	12	2018-02-17 12:00:00	8852	8694	158	100	698	7
2311	2	12	2018-02-17 13:00:00	9376	9342	34	113	820	7
2312	2	12	2018-02-17 14:00:00	7656	7560	96	138	706	14
2313	2	12	2018-02-17 15:00:00	8696	8856	-160	104	562	14
2314	2	12	2018-02-17 16:00:00	8719	8532	187	81	974	7
2315	2	12	2018-02-17 17:00:00	8664	8532	132	128	450	7
2316	2	12	2018-02-17 18:00:00	9424	9396	28	102	860	7
2317	2	12	2018-02-17 19:00:00	7908	7830	78	70	798	7
2318	2	12	2018-02-17 20:00:00	9564	9504	60	112	738	7
2319	2	12	2018-02-17 21:00:00	8556	8748	-192	116	668	7
2320	2	12	2018-02-17 22:00:00	8312	8100	212	133	390	6
2321	2	12	2018-02-17 23:00:00	8816	8694	122	116	572	10
2322	2	12	2018-02-18 00:00:00	9244	9180	64	7	3402	4
2323	2	12	2018-02-18 01:00:00	9368	9288	80	126	1018	4
2324	2	12	2018-02-18 02:00:00	9248	9342	-94	144	870	4
2325	2	12	2018-02-18 03:00:00	516	396	120	148	652	4
2326	2	2	2018-02-18 03:00:00	516	396	120	148	652	4
2327	2	2	2018-02-18 04:00:00	7972	7776	196	122	778	4
2328	2	2	2018-02-18 05:00:00	8659	8856	-197	132	630	4
2329	2	2	2018-02-18 06:00:00	8464	8208	256	193	566	8
2330	2	2	2018-02-18 07:00:00	8652	8586	66	147	600	4
2331	2	2	2018-02-18 08:00:00	9068	9126	-58	138	602	4
2332	2	2	2018-02-18 09:00:00	9140	9018	122	51	212	4
2333	2	2	2018-02-18 10:00:00	9268	9234	34	70	350	4
2334	2	2	2018-02-18 11:00:00	9308	9234	74	48	868	4
2335	2	2	2018-02-18 12:00:00	9439	9396	43	40	676	4
2336	2	2	2018-02-18 13:00:00	8903	8856	47	66	410	4
2337	2	2	2018-02-18 14:00:00	9060	9018	42	56	668	8
2338	2	2	2018-02-18 15:00:00	8364	8316	48	71	446	8
2339	2	2	2018-02-18 16:00:00	10056	9990	66	86	832	4
2340	2	2	2018-02-18 17:00:00	7680	7632	48	44	996	4
2341	2	2	2018-02-18 18:00:00	9236	9180	56	60	484	4
2342	2	2	2018-02-18 19:00:00	9035	8964	71	54	542	4
2343	2	2	2018-02-18 20:00:00	8428	8370	58	53	380	4
2344	2	2	2018-02-18 21:00:00	8827	8802	25	71	296	4
2345	2	2	2018-02-18 22:00:00	8512	8478	34	67	472	8
2346	2	2	2018-02-18 23:00:00	7019	6966	53	69	266	13
2347	2	2	2018-02-19 00:00:00	8132	8100	32	65	266	9
2348	2	2	2018-02-19 01:00:00	8764	8694	70	69	744	9
2349	2	2	2018-02-19 02:00:00	9476	9396	80	90	478	9
2350	2	2	2018-02-19 03:00:00	9516	9504	12	67	232	9
2351	2	2	2018-02-19 04:00:00	9248	9180	68	81	322	9
2352	2	2	2018-02-19 05:00:00	9232	9288	-56	80	380	9
2353	2	2	2018-02-19 06:00:00	8364	8208	156	40	538	16
2354	2	2	2018-02-19 07:00:00	6328	6210	118	188	1664	9
2355	2	2	2018-02-19 08:00:00	0	54	-54	154	2040	9
2356	2	2	2018-02-19 10:00:00	348	288	60	23	224	9
2357	2	2	2018-02-19 11:00:00	4804	4806	-2	45	5206	9
2358	2	2	2018-02-19 12:00:00	4212	4212	0	9	122	9
2359	2	2	2018-02-19 13:00:00	872	810	62	60	554	9
2360	2	2	2018-02-19 14:00:00	3232	3186	46	40	836	16
2361	2	2	2018-02-19 15:00:00	5992	6048	-56	66	1298	16
2362	2	2	2018-02-19 16:00:00	5672	5616	56	56	796	9
2363	2	2	2018-02-19 17:00:00	4359	4266	93	45	3334	9
2364	2	2	2018-02-19 18:00:00	8828	8748	80	6	1312	9
2365	2	2	2018-02-19 19:00:00	7338	7236	102	46	2286	9
2366	2	2	2018-02-19 20:00:00	8788	8748	40	29	2306	9
2367	2	2	2018-02-19 21:00:00	8644	8586	58	15	3152	9
2368	2	2	2018-02-19 22:00:00	6946	7344	-398	12	3180	16
2369	2	2	2018-02-19 23:00:00	0	36	-36	26	1206	16
2370	2	12	2018-02-20 00:00:00	514	108	406	43	1140	9
2371	2	12	2018-02-20 01:00:00	10168	9936	232	40	3608	9
2372	2	12	2018-02-20 02:00:00	10368	10368	0	36	376	9
2373	2	12	2018-02-20 03:00:00	9131	8910	221	84	414	9
2374	2	12	2018-02-20 04:00:00	2010	1836	174	120	510	9
2375	2	12	2018-02-20 05:00:00	8350	8208	142	71	664	9
2376	2	12	2018-02-20 06:00:00	9980	9882	98	69	1550	16
2377	2	12	2018-02-20 07:00:00	9747	9612	135	63	296	9
2378	2	12	2018-02-20 08:00:00	9880	9828	52	114	568	9
2379	2	12	2018-02-20 09:00:00	8884	8748	136	74	624	9
2380	2	12	2018-02-20 10:00:00	7144	7020	124	31	3314	9
2381	2	12	2018-02-20 11:00:00	6000	5940	60	20	1096	9
2382	2	12	2018-02-20 12:00:00	7315	7236	79	36	2830	9
2383	2	12	2018-02-20 13:00:00	10384	10476	-92	11	4274	9
2384	2	12	2018-02-20 14:00:00	8828	8802	26	17	1560	16
2385	2	12	2018-02-20 15:00:00	7392	7128	264	55	1920	16
2386	2	12	2018-02-20 16:00:00	7275	7398	-123	26	716	9
2387	2	12	2018-02-20 17:00:00	268	216	52	87	912	9
2388	2	12	2018-02-20 18:00:00	6255	5994	261	22	5214	9
2389	2	12	2018-02-20 19:00:00	9212	9126	86	21	266	9
2390	2	12	2018-02-20 20:00:00	7468	7398	70	44	550	9
2391	2	12	2018-02-20 21:00:00	5232	5346	-114	62	632	9
2392	2	12	2018-02-20 22:00:00	6957	6804	153	67	346	16
2393	2	12	2018-02-20 23:00:00	8951	8856	95	57	424	16
2394	2	12	2018-02-21 00:00:00	9604	9558	46	61	678	9
2395	2	12	2018-02-21 01:00:00	9924	9882	42	56	442	9
2396	2	12	2018-02-21 02:00:00	8484	8586	-102	95	668	9
2397	2	12	2018-02-21 03:00:00	6860	6588	272	59	2616	9
2398	2	12	2018-02-21 04:00:00	2332	2376	-44	163	730	9
2399	2	12	2018-02-21 05:00:00	4824	4752	72	68	990	9
2400	2	12	2018-02-21 06:00:00	6064	5922	142	86	484	16
2401	2	12	2018-02-21 14:00:00	164	54	110	111	622	16
2402	2	12	2018-02-21 15:00:00	8224	8100	124	126	386	16
2403	2	12	2018-02-21 16:00:00	8336	8316	20	116	414	9
2404	2	12	2018-02-21 17:00:00	2515	2952	-437	140	596	4
2405	2	2	2018-02-21 18:00:00	2958	2376	582	130	702	4
2406	2	2	2018-02-21 19:00:00	4587	4644	-57	120	388	4
2407	2	2	2018-02-21 20:00:00	6736	6534	202	192	576	4
2408	2	2	2018-02-21 21:00:00	9956	9774	182	183	612	4
2409	2	2	2018-02-21 22:00:00	10040	9882	158	198	540	8
2410	2	2	2018-02-21 23:00:00	9396	9288	108	211	840	8
2411	2	2	2018-02-22 00:00:00	9444	9450	-6	198	742	4
2412	2	2	2018-02-22 01:00:00	10080	9936	144	184	674	4
2413	2	2	2018-02-22 02:00:00	10192	10044	148	192	758	4
2414	2	2	2018-02-22 03:00:00	9624	9666	-42	108	386	4
2415	2	2	2018-02-22 04:00:00	10176	10098	78	147	586	4
2416	2	2	2018-02-22 05:00:00	10420	10422	-2	107	1342	4
2417	2	2	2018-02-22 06:00:00	8828	8694	134	40	1828	8
2418	2	2	2018-02-22 07:00:00	6840	6858	-18	89	486	4
2419	2	2	2018-02-22 08:00:00	6316	6156	160	140	730	4
2420	2	2	2018-02-22 09:00:00	6140	6048	92	156	1050	4
2421	2	2	2018-02-22 10:00:00	9646	9774	-128	173	606	4
2422	2	2	2018-02-22 11:00:00	8536	8532	4	139	864	4
2423	2	2	2018-02-22 12:00:00	7180	7020	160	165	540	4
2424	2	2	2018-02-22 13:00:00	10724	10584	140	152	846	4
2425	2	2	2018-02-22 14:00:00	9712	9558	154	142	418	8
2426	2	2	2018-02-22 15:00:00	9672	9666	6	141	918	8
2427	2	2	2018-02-22 16:00:00	10120	10044	76	165	830	4
2428	2	2	2018-02-22 17:00:00	8248	8262	-14	172	888	4
2429	2	2	2018-02-22 18:00:00	9564	9450	114	151	992	4
2430	2	2	2018-02-22 19:00:00	10060	10044	16	122	1472	4
2431	2	2	2018-02-22 20:00:00	8388	8424	-36	149	768	4
2432	2	2	2018-02-22 21:00:00	9040	8910	130	179	610	4
2433	2	2	2018-02-22 22:00:00	10628	10476	152	173	628	8
2434	2	2	2018-02-22 23:00:00	7852	7830	22	118	5262	8
2435	2	2	2018-02-23 00:00:00	9052	8964	88	11	1610	4
2436	2	2	2018-02-23 01:00:00	8944	8964	-20	41	1254	7
2437	2	2	2018-02-23 02:00:00	5684	5598	86	63	3850	3
2438	2	2	2018-02-23 03:00:00	7420	7398	22	56	1258	3
2439	2	2	2018-02-23 04:00:00	10168	10044	124	5	4598	3
2440	2	2	2018-02-23 05:00:00	2786	3348	-562	86	5262	3
2441	2	2	2018-02-23 06:00:00	8374	7776	598	23	3012	6
2442	2	2	2018-02-23 06:00:00	8374	7776	598	23	3012	6
2443	2	15	2018-02-23 06:00:00	8374	7776	598	23	3012	6
2444	2	2	2018-02-23 07:00:00	8712	8640	72	26	184	3
2445	2	2	2018-02-23 07:00:00	8712	8640	72	26	184	3
2446	2	15	2018-02-23 07:00:00	8712	8640	72	26	184	3
2447	2	2	2018-02-23 08:00:00	9718	9774	-56	33	388	3
2448	2	2	2018-02-23 08:00:00	9718	9774	-56	33	388	3
2449	2	15	2018-02-23 08:00:00	9718	9774	-56	33	388	3
2450	2	2	2018-02-23 09:00:00	7514	7344	170	86	420	3
2451	2	2	2018-02-23 09:00:00	7514	7344	170	86	420	3
2452	2	15	2018-02-23 09:00:00	7514	7344	170	86	420	3
2453	2	2	2018-02-23 10:00:00	6966	6966	0	80	734	3
2454	2	2	2018-02-23 10:00:00	6966	6966	0	80	734	3
2455	2	15	2018-02-23 10:00:00	6966	6966	0	80	734	3
2456	2	2	2018-02-23 11:00:00	5084	5130	-46	158	768	3
2457	2	2	2018-02-23 11:00:00	5084	5130	-46	158	768	3
2458	2	15	2018-02-23 11:00:00	5084	5130	-46	158	768	3
2459	2	2	2018-02-23 12:00:00	9914	9828	86	177	652	3
2460	2	2	2018-02-23 12:00:00	9914	9828	86	177	652	3
2461	2	15	2018-02-23 12:00:00	9914	9828	86	177	652	3
2462	2	2	2018-02-23 13:00:00	9806	9720	86	147	734	3
2463	2	2	2018-02-23 13:00:00	9806	9720	86	147	734	3
2464	2	15	2018-02-23 13:00:00	9806	9720	86	147	734	3
2465	2	2	2018-02-23 14:00:00	8968	8856	112	93	1444	6
2466	2	2	2018-02-23 14:00:00	8968	8856	112	93	1444	6
2467	2	15	2018-02-23 14:00:00	8968	8856	112	93	1444	6
2468	2	2	2018-02-23 15:00:00	10516	10422	94	99	430	6
2469	2	2	2018-02-23 15:00:00	10516	10422	94	99	430	6
2470	2	15	2018-02-23 15:00:00	10516	10422	94	99	430	6
2471	2	2	2018-02-23 16:00:00	9814	9990	-176	119	1086	3
2472	2	2	2018-02-23 16:00:00	9814	9990	-176	119	1086	3
2473	2	15	2018-02-23 16:00:00	9814	9990	-176	119	1086	3
2474	2	2	2018-02-23 17:00:00	9656	9450	206	88	538	3
2475	2	2	2018-02-23 17:00:00	9656	9450	206	88	538	3
2476	2	15	2018-02-23 17:00:00	9656	9450	206	88	538	3
2477	2	2	2018-02-23 18:00:00	5682	5670	12	85	434	9
2478	2	2	2018-02-23 18:00:00	5682	5670	12	85	434	9
2479	2	15	2018-02-23 18:00:00	5682	5670	12	85	434	9
2480	2	2	2018-02-23 19:00:00	9250	9072	178	120	660	6
2481	2	2	2018-02-23 19:00:00	9250	9072	178	120	660	6
2482	2	15	2018-02-23 19:00:00	9250	9072	178	120	660	6
2483	2	2	2018-02-23 20:00:00	9112	9126	-14	60	4248	6
2484	2	2	2018-02-23 20:00:00	9112	9126	-14	60	4248	6
2485	2	15	2018-02-23 20:00:00	9112	9126	-14	60	4248	6
2486	2	2	2018-02-23 21:00:00	9560	9396	164	75	348	6
2487	2	2	2018-02-23 21:00:00	9560	9396	164	75	348	6
2488	2	15	2018-02-23 21:00:00	9560	9396	164	75	348	6
2489	2	2	2018-02-23 22:00:00	6656	6804	-148	172	512	18
2490	2	2	2018-02-23 22:00:00	6656	6804	-148	172	512	18
2491	2	15	2018-02-23 22:00:00	6656	6804	-148	172	512	18
2492	2	2	2018-02-23 23:00:00	9324	9018	306	179	1174	16
2493	2	2	2018-02-23 23:00:00	9324	9018	306	179	1174	16
2494	2	15	2018-02-23 23:00:00	9324	9018	306	179	1174	16
2495	2	2	2018-02-24 00:00:00	9768	9774	-6	153	818	8
2496	2	2	2018-02-24 00:00:00	9768	9774	-6	153	818	8
2497	2	15	2018-02-24 00:00:00	9768	9774	-6	153	818	8
2498	2	2	2018-02-24 01:00:00	5812	5670	142	1	22856	8
2499	2	2	2018-02-24 01:00:00	5812	5670	142	1	22856	8
2500	2	15	2018-02-24 01:00:00	5812	5670	142	1	22856	8
2501	2	2	2018-02-24 12:00:00	328	72	256	19	27600	8
2502	2	2	2018-02-24 12:00:00	328	72	256	19	27600	8
2503	2	15	2018-02-24 12:00:00	328	72	256	19	27600	8
2504	2	2	2018-02-24 13:00:00	3628	3924	-296	23	208	8
2505	2	2	2018-02-24 13:00:00	3628	3924	-296	23	208	8
2506	2	15	2018-02-24 13:00:00	3628	3924	-296	23	208	8
2507	2	2	2018-02-24 14:00:00	3861	3294	567	35	608	16
2508	2	2	2018-02-24 15:00:00	7783	7776	7	35	202	16
2509	2	2	2018-02-24 16:00:00	10508	10422	86	32	326	8
2510	2	2	2018-02-24 17:00:00	10124	10098	26	20	516	8
2511	2	2	2018-02-24 18:00:00	9283	9234	49	47	354	8
2512	2	2	2018-02-24 19:00:00	9720	9666	54	95	1402	8
2513	2	2	2018-02-24 20:00:00	10544	10422	122	49	864	8
2514	2	2	2018-02-24 21:00:00	10128	10098	30	127	820	8
2515	2	2	2018-02-24 22:00:00	10276	10314	-38	160	516	16
2516	2	2	2018-02-24 23:00:00	8368	8262	106	145	630	16
2517	2	2	2018-02-25 00:00:00	10156	10098	58	161	494	8
2518	2	2	2018-02-25 01:00:00	10306	10260	46	140	494	8
2519	2	2	2018-02-25 02:00:00	10256	10206	50	152	358	8
2520	2	2	2018-02-25 03:00:00	10456	10422	34	140	670	8
2521	2	2	2018-02-25 04:00:00	10487	10422	65	140	472	8
2522	2	2	2018-02-25 05:00:00	9440	9342	98	118	452	8
2523	2	2	2018-02-25 06:00:00	10339	10368	-29	149	544	16
2524	2	2	2018-02-25 07:00:00	9516	9504	12	161	486	8
2525	2	2	2018-02-25 08:00:00	6760	6696	64	144	2532	8
2526	2	2	2018-02-25 09:00:00	3392	3294	98	27	3194	8
2527	2	2	2018-02-25 10:00:00	9920	9936	-16	30	1406	8
2528	2	2	2018-02-25 11:00:00	9896	9828	68	90	632	8
2529	2	2	2018-02-25 12:00:00	10056	9990	66	95	1300	12
2530	2	2	2018-02-25 13:00:00	9299	9180	119	130	730	4
2531	2	2	2018-02-25 14:00:00	9780	9774	6	130	1226	8
2532	2	2	2018-02-25 15:00:00	9820	9828	-8	85	1210	8
2533	2	2	2018-02-25 16:00:00	8790	8748	42	125	992	4
2534	2	2	2018-02-25 17:00:00	10388	10314	74	126	1074	4
2535	2	2	2018-02-25 18:00:00	10040	9936	104	111	978	4
2536	2	2	2018-02-25 19:00:00	9840	9774	66	151	904	4
2537	2	2	2018-02-25 20:00:00	9820	9774	46	143	506	4
2538	2	2	2018-02-25 21:00:00	10587	10584	3	155	586	4
2539	2	2	2018-02-25 22:00:00	3526	4050	-524	210	740	8
2540	2	12	2018-02-25 23:00:00	5222	4698	524	161	424	11
2541	2	12	2018-02-26 00:00:00	10404	10368	36	166	502	7
2542	2	12	2018-02-26 01:00:00	9448	9342	106	167	512	7
2543	2	12	2018-02-26 02:00:00	10500	10422	78	171	2714	7
2544	2	12	2018-02-26 03:00:00	10288	10206	82	4	2924	7
2545	2	12	2018-02-26 04:00:00	10488	10476	12	24	2150	7
2546	2	12	2018-02-26 05:00:00	10236	10152	84	115	1044	7
2547	2	12	2018-02-26 06:00:00	8548	8478	70	27	234	14
2548	2	12	2018-02-26 07:00:00	9348	9396	-48	118	782	7
2549	2	12	2018-02-26 08:00:00	10472	10368	104	47	382	11
2550	2	12	2018-02-26 09:00:00	8616	8532	84	40	810	4
2551	2	12	2018-02-26 10:00:00	9916	9882	34	29	1186	4
2552	2	12	2018-02-26 11:00:00	8531	8424	107	28	260	4
2553	2	12	2018-02-26 12:00:00	7588	7830	-242	39	1206	4
2554	2	12	2018-02-26 13:00:00	10388	10206	182	23	238	4
2555	2	12	2018-02-26 14:00:00	7234	7128	106	70	456	8
2556	2	12	2018-02-26 15:00:00	10488	10368	120	56	558	8
2557	2	12	2018-02-26 16:00:00	9612	9612	0	74	538	4
2558	2	12	2018-02-26 17:00:00	9444	9342	102	85	3170	4
2559	2	12	2018-02-26 18:00:00	9448	9396	52	39	604	4
2560	2	12	2018-02-26 19:00:00	5540	5724	-184	27	200	4
2561	2	12	2018-02-26 20:00:00	4938	4644	294	38	566	4
2562	2	12	2018-02-26 21:00:00	10588	10584	4	36	260	4
2563	2	12	2018-02-26 22:00:00	9200	9180	20	39	652	8
2564	2	12	2018-02-26 23:00:00	10498	10584	-86	27	2974	8
2565	2	12	2018-02-27 00:00:00	9044	8748	296	22	334	7
2566	2	12	2018-02-27 01:00:00	1828	1980	-152	56	388	7
2567	2	12	2018-02-27 01:00:00	1828	1980	-152	56	388	7
2568	2	12	2018-02-27 02:00:00	10136	9882	254	31	180	7
2569	2	12	2018-02-27 03:00:00	9791	9720	71	29	242	7
2570	2	12	2018-02-27 04:00:00	10515	10530	-15	52	806	7
2571	2	12	2018-02-27 05:00:00	10458	10314	144	61	434	7
2572	2	12	2018-02-27 06:00:00	8740	8748	-8	33	504	14
2573	2	12	2018-02-27 07:00:00	9568	9504	64	55	534	7
2574	2	12	2018-02-27 08:00:00	9654	9612	42	28	690	4
2575	2	12	2018-02-27 09:00:00	8273	8208	65	23	284	8
2576	2	12	2018-02-27 10:00:00	9383	9342	41	35	458	4
2577	2	12	2018-02-27 11:00:00	9471	9396	75	27	158	4
2578	2	12	2018-02-27 12:00:00	8992	8964	28	17	300	4
2579	2	12	2018-02-27 13:00:00	10340	10260	80	26	290	4
2580	2	12	2018-02-27 14:00:00	9664	9558	106	96	558	8
2581	2	12	2018-02-27 15:00:00	10618	10638	-20	36	242	8
2582	2	12	2018-02-27 16:00:00	10242	10206	36	33	324	4
2583	2	12	2018-02-27 17:00:00	10424	10314	110	30	216	4
2584	2	12	2018-02-27 18:00:00	10158	10152	6	52	960	4
2585	2	12	2018-02-27 19:00:00	10548	10530	18	61	582	4
2586	2	12	2018-02-27 20:00:00	8390	8370	20	39	722	4
2587	2	12	2018-02-27 21:00:00	8910	8802	108	32	568	4
2588	2	12	2018-02-27 22:00:00	8838	8856	-18	35	984	8
2589	2	12	2018-02-27 23:00:00	9520	9396	124	40	404	8
2590	2	12	2018-02-28 00:00:00	8524	8316	208	36	2636	4
2591	2	12	2018-02-28 01:00:00	9300	9396	-96	27	260	7
2592	2	12	2018-02-28 02:00:00	5434	5976	-542	43	888	7
2593	2	2	2018-02-28 03:00:00	7638	7020	618	35	224	7
2594	2	2	2018-02-28 04:00:00	8876	8856	20	81	552	7
2595	2	2	2018-02-28 05:00:00	9956	9936	20	38	520	7
2596	2	2	2018-02-28 06:00:00	9384	9342	42	47	474	14
2597	2	2	2018-02-28 07:00:00	9508	9450	58	38	2246	7
2598	2	2	2018-02-28 08:00:00	9715	9720	-5	52	696	7
2599	2	2	2018-02-28 09:00:00	4284	4158	126	76	2542	7
2600	2	2	2018-02-28 10:00:00	9067	8964	103	35	1490	7
2601	2	2	2018-02-28 11:00:00	4568	4590	-22	34	856	7
2602	2	2	2018-02-28 12:00:00	5248	5022	226	57	1018	7
2603	2	2	2018-02-28 13:00:00	8312	8316	-4	55	508	7
2604	2	2	2018-02-28 14:00:00	8176	8208	-32	85	408	14
2605	2	2	2018-02-28 15:00:00	9247	9126	121	35	316	14
2606	2	2	2018-02-28 16:00:00	9856	9774	82	40	546	7
2607	2	2	2018-02-28 17:00:00	10112	10098	14	31	390	7
2608	2	2	2018-02-28 18:00:00	9488	9396	92	27	232	7
2609	2	2	2018-02-28 19:00:00	9996	9990	6	26	698	7
2610	2	2	2018-02-28 20:00:00	9200	9234	-34	13	502	7
2611	2	2	2018-02-28 21:00:00	10532	10314	218	57	1696	7
2612	2	2	2018-02-28 22:00:00	5794	5994	-200	37	534	14
2613	2	2	2018-03-01 06:00:00	2948	2808	140	32	862	14
2614	2	2	2018-03-01 07:00:00	9428	9342	86	30	498	7
2615	2	2	2018-03-01 08:00:00	8196	8154	42	37	802	7
2616	2	2	2018-03-01 09:00:00	9684	9666	18	29	334	7
2617	2	2	2018-03-01 10:00:00	8772	8802	-30	14	490	7
2618	2	2	2018-03-01 11:00:00	9972	9774	198	30	644	7
2619	2	2	2018-03-01 12:00:00	9624	9666	-42	26	486	7
2620	2	2	2018-03-01 13:00:00	9198	9072	126	27	236	7
2621	2	2	2018-03-01 14:00:00	9680	9558	122	30	432	14
2622	2	2	2018-03-01 15:00:00	9720	9666	54	36	792	14
2623	2	2	2018-03-01 16:00:00	10412	10422	-10	27	132556	7
2624	2	2	2018-03-01 17:00:00	9111	8964	147	1	36598	7
2625	2	2	2018-03-01 18:00:00	9751	9828	-77	25	1316	7
2626	2	2	2018-03-01 19:00:00	8944	8802	142	18	1876	7
2627	2	2	2018-03-01 20:00:00	5322	5886	-564	22	394	7
