DateTime_Out,Line,Feed,OutputGood,Scrap,Error_Count,Sum_Duration,Staff
2018-01-02 06:00:00,1,1982,1296,686,20,2522,2.5
2018-01-02 06:00:00,2,1246,594,652,2,52,2.5
2018-01-02 07:00:00,1,3892,3834,58,16,370,2.5
2018-01-02 07:00:00,2,6640,6570,70,28,1430,2.5
2018-01-02 08:00:00,1,6256,5994,262,45,1508,2.5
2018-01-02 08:00:00,2,10060,9990,70,29,268,2.5
2018-01-02 09:00:00,1,6480,6210,270,30,1512,2.5
2018-01-02 09:00:00,2,4687,5202,-515,39,3936,2.5
2018-01-02 10:00:00,1,7682,7452,230,43,1114,5.0
2018-01-02 10:00:00,2,4474,3996,478,16,260,5.166666666666666
2018-01-02 11:00:00,1,7948,7668,280,42,990,5.166666666666666
2018-01-02 11:00:00,2,9608,9396,212,29,484,5.166666666666666
2018-01-02 12:00:00,1,7688,7452,236,24,1124,5.166666666666666
2018-01-02 12:00:00,2,10840,10746,94,18,146,5.166666666666666
2018-01-02 13:00:00,1,7276,7398,-122,22,2982,5.166666666666666
2018-01-02 13:00:00,2,10076,10098,-22,52,294,5.166666666666666
2018-01-02 14:00:00,1,5356,5184,172,12,130,7.833333333333332
2018-01-02 14:00:00,2,10007,9990,17,56,382,5.166666666666666
2018-01-02 15:00:00,1,10776,10584,192,14,130,5.166666666666666
2018-01-02 15:00:00,2,9928,9828,100,43,372,5.166666666666666
2018-01-02 16:00:00,1,9680,9720,-40,27,6656,5.166666666666666
2018-01-02 16:00:00,2,10260,10098,162,28,298,5.166666666666666
2018-01-02 17:00:00,2,11024,10962,62,14,38,5.166666666666666
2018-01-02 18:00:00,1,3136,3078,58,13,142,5.166666666666666
2018-01-02 18:00:00,2,9632,9558,74,49,492,5.166666666666666
2018-01-02 19:00:00,1,8880,8856,24,121,674,5.166666666666666
2018-01-02 19:00:00,2,10476,10368,108,35,224,5.166666666666666
2018-01-02 20:00:00,1,8551,8316,235,88,708,5.166666666666666
2018-01-02 20:00:00,2,10400,10368,32,19,232,5.166666666666666
2018-01-02 21:00:00,1,6772,6696,76,105,1380,5.166666666666666
2018-01-02 21:00:00,2,10452,10422,30,20,246,5.166666666666666
2018-01-02 22:00:00,1,3512,4014,-502,75,4828,5.166666666666666
2018-01-02 22:00:00,2,9747,9666,81,37,432,7.833333333333332
2018-01-02 23:00:00,1,2230,1674,556,37,788,5.166666666666666
2018-01-02 23:00:00,2,10380,10314,66,29,228,5.166666666666666
2018-01-03 00:00:00,1,7460,7398,62,53,830,5.166666666666666
2018-01-03 00:00:00,2,9776,9666,110,29,472,5.166666666666666
2018-01-03 01:00:00,1,8324,8208,116,30,868,5.166666666666666
2018-01-03 01:00:00,2,9232,9180,52,74,650,5.166666666666666
2018-01-03 02:00:00,1,9796,9828,-32,52,422,5.166666666666666
2018-01-03 02:00:00,2,9872,9882,-10,58,290,7.833333333333332
2018-01-03 03:00:00,1,9632,9288,344,57,536,5.166666666666666
2018-01-03 03:00:00,2,9264,9180,84,62,634,5.166666666666666
2018-01-03 04:00:00,1,9899,9828,71,32,496,5.166666666666666
2018-01-03 04:00:00,2,1304,1332,-28,18,3050,5.166666666666666
2018-01-03 05:00:00,1,8460,8532,-72,62,848,5.166666666666666
2018-01-03 05:00:00,2,10288,10152,136,81,276,5.166666666666666
2018-01-03 06:00:00,1,6335,6048,287,50,1376,5.166666666666666
2018-01-03 06:00:00,2,5239,5292,-53,16,2990,5.166666666666666
2018-01-03 07:00:00,1,8443,8424,19,61,878,5.166666666666666
2018-01-03 07:00:00,2,6496,6426,70,21,392,5.166666666666666
2018-01-03 08:00:00,1,9244,9126,118,63,542,5.166666666666666
2018-01-03 08:00:00,2,9823,9828,-5,23,430,5.166666666666666
2018-01-03 09:00:00,1,7912,7722,190,77,1012,5.166666666666666
2018-01-03 09:00:00,2,9296,9270,26,66,648,5.166666666666666
2018-01-03 10:00:00,1,8352,8262,90,46,884,5.166666666666666
2018-01-03 10:00:00,2,5856,5670,186,38,1652,7.833333333333332
2018-01-03 11:00:00,1,9771,9666,105,43,404,4.833333333333332
2018-01-03 11:00:00,2,9712,9666,46,28,458,4.833333333333332
2018-01-03 12:00:00,1,7632,7452,180,52,1264,4.833333333333332
2018-01-03 12:00:00,2,10056,10098,-42,44,338,4.833333333333332
2018-01-03 13:00:00,1,8544,8424,120,58,718,4.833333333333332
2018-01-03 13:00:00,2,8024,7884,140,41,1034,4.833333333333332
2018-01-03 14:00:00,1,6661,6588,73,80,1360,4.833333333333332
2018-01-03 14:00:00,2,9562,9558,4,32,474,6.833333333333332
2018-01-03 15:00:00,1,9024,8856,168,51,628,4.833333333333332
2018-01-03 15:00:00,2,10388,10260,128,34,258,4.833333333333332
2018-01-03 16:00:00,1,9207,9072,135,53,620,4.833333333333332
2018-01-03 16:00:00,2,10380,10314,66,64,252,4.833333333333332
2018-01-03 17:00:00,1,8819,8802,17,63,704,4.833333333333332
2018-01-03 17:00:00,2,9464,9450,14,21,508,4.833333333333332
2018-01-03 18:00:00,1,8296,8046,250,44,4364,4.833333333333332
2018-01-03 18:00:00,2,4134,3996,138,44,2272,4.833333333333332
2018-01-03 19:00:00,2,5912,5832,80,1,3866,4.833333333333332
2018-01-03 20:00:00,2,5844,5832,12,17,3322,4.833333333333332
2018-01-03 21:00:00,1,8120,8154,-34,1,46,4.833333333333332
2018-01-03 21:00:00,2,10183,10206,-23,20,172,4.833333333333332
2018-01-03 22:00:00,1,7980,7722,258,42,840,4.833333333333332
2018-01-03 22:00:00,2,10272,10260,12,33,230,4.833333333333332
2018-01-03 23:00:00,1,9264,9072,192,25,1052,4.833333333333332
2018-01-03 23:00:00,2,10032,9936,96,42,264,6.833333333333332
2018-01-04 00:00:00,1,4488,4320,168,19,900,4.833333333333332
2018-01-04 00:00:00,2,8572,8478,94,33,362,4.833333333333332
2018-01-04 01:00:00,1,7796,7614,182,31,1908,4.833333333333332
2018-01-04 01:00:00,2,10136,10044,92,35,874,4.833333333333332
2018-01-04 02:00:00,1,9419,9342,77,32,1502,4.833333333333332
2018-01-04 02:00:00,2,8567,8532,35,37,356,4.833333333333332
2018-01-04 03:00:00,1,8223,7938,285,69,550,4.833333333333332
2018-01-04 03:00:00,2,10331,10260,71,43,850,6.833333333333332
2018-01-04 04:00:00,1,9356,9126,230,75,882,4.833333333333332
2018-01-04 04:00:00,2,9960,9882,78,45,192,4.833333333333332
2018-01-04 05:00:00,1,9904,9882,22,29,580,4.833333333333332
2018-01-04 05:00:00,2,10532,10584,-52,45,400,4.833333333333332
2018-01-04 06:00:00,1,9168,9126,42,25,388,4.833333333333332
2018-01-04 06:00:00,2,10620,10476,144,26,210,4.833333333333332
2018-01-04 07:00:00,1,5104,4914,190,47,672,4.833333333333332
2018-01-04 07:00:00,2,9154,9126,28,23,182,4.833333333333332
2018-01-04 08:00:00,1,684,540,144,14,17022,4.833333333333332
2018-01-04 08:00:00,2,10076,10044,32,28,606,4.833333333333332
2018-01-04 09:00:00,1,7967,7884,83,44,350,4.833333333333332
2018-01-04 09:00:00,2,10296,10260,36,28,272,4.833333333333332
2018-01-04 10:00:00,1,2358,2376,-18,27,512,4.833333333333332
2018-01-04 10:00:00,2,9768,9666,102,29,458,4.833333333333332
2018-01-04 11:00:00,1,152,162,-10,33,1002,4.833333333333332
2018-01-04 11:00:00,2,9536,9558,-22,32,3260,6.833333333333332
2018-01-04 12:00:00,1,5791,5724,67,48,1066,4.833333333333332
2018-01-04 12:00:00,2,7762,8154,-392,31,322,4.833333333333332
2018-01-04 13:00:00,1,8924,8748,176,45,532,4.833333333333332
2018-01-04 13:00:00,2,3522,2970,552,28,382,4.833333333333332
2018-01-04 14:00:00,1,8240,8262,-22,28,6306,4.833333333333332
2018-01-04 14:00:00,2,9892,9828,64,22,3840,4.833333333333332
2018-01-04 15:00:00,1,5650,6120,-470,12,842,4.833333333333332
2018-01-04 15:00:00,2,5144,5022,122,45,714,6.833333333333332
2018-01-04 16:00:00,2,2914,2808,106,35,544,4.833333333333332
2018-01-04 17:00:00,1,6066,5616,450,25,854,4.833333333333332
2018-01-04 17:00:00,2,9268,9234,34,71,846,4.833333333333332
2018-01-04 18:00:00,1,8280,8100,180,53,978,4.833333333333332
2018-01-04 18:00:00,2,8464,8478,-14,29,352,4.833333333333332
2018-01-04 19:00:00,1,8100,8046,54,39,458,4.833333333333332
2018-01-04 19:00:00,2,10139,10044,95,65,474,4.833333333333332
2018-01-04 20:00:00,1,9710,9558,152,37,492,5.499999999999998
2018-01-04 20:00:00,2,9536,9504,32,49,1074,5.499999999999998
2018-01-04 21:00:00,1,9584,9504,80,29,894,5.499999999999998
2018-01-04 21:00:00,2,7904,7884,20,53,1130,5.499999999999998
2018-01-04 22:00:00,1,8263,8316,-53,73,280,5.499999999999998
2018-01-04 22:00:00,2,7868,7776,92,32,290,5.499999999999998
2018-01-04 23:00:00,1,10224,10152,72,28,728,5.499999999999998
2018-01-04 23:00:00,2,9948,9882,66,43,396,5.499999999999998
2018-01-05 00:00:00,1,8868,8748,120,19,4296,9.499999999999998
2018-01-05 00:00:00,2,9888,9828,60,47,374,5.499999999999998
2018-01-05 01:00:00,1,6256,6156,100,5,948,5.499999999999998
2018-01-05 01:00:00,2,10358,10260,98,27,174,5.499999999999998
2018-01-05 02:00:00,1,52,54,-2,20,448,5.499999999999998
2018-01-05 02:00:00,2,10210,10152,58,44,462,5.499999999999998
2018-01-05 03:00:00,1,9400,9414,-14,35,362,5.499999999999998
2018-01-05 03:00:00,2,9828,9720,108,40,390,5.499999999999998
2018-01-05 04:00:00,1,10104,10044,60,66,470,9.499999999999998
2018-01-05 04:00:00,2,9856,9882,-26,56,458,5.499999999999998
2018-01-05 05:00:00,1,9430,9396,34,76,618,5.499999999999998
2018-01-05 05:00:00,2,9696,9720,-24,66,570,5.499999999999998
2018-01-05 06:00:00,1,9128,9018,110,129,2846,5.499999999999998
2018-01-05 06:00:00,2,9340,9072,268,72,498,5.499999999999998
2018-01-05 07:00:00,1,6946,7416,-470,2,3796,5.499999999999998
2018-01-05 07:00:00,2,9466,9450,16,49,954,5.499999999999998
2018-01-05 08:00:00,2,9830,9720,110,1,8330,5.499999999999998
2018-01-05 09:00:00,2,8088,7938,150,25,476,5.499999999999998
2018-01-05 10:00:00,2,9740,9774,-34,101,444,5.499999999999998
2018-01-05 11:00:00,2,9712,9558,154,4,854,5.499999999999998
2018-01-05 12:00:00,2,3450,4014,-564,38,454,5.499999999999998
2018-01-05 13:00:00,2,3598,3024,574,2,8004,5.499999999999998
2018-01-05 14:00:00,1,3868,3510,358,22,4638,5.499999999999998
2018-01-05 14:00:00,2,4924,4860,64,9,206,5.499999999999998
2018-01-05 15:00:00,1,9980,9828,152,9,1310,9.499999999999998
2018-01-05 15:00:00,2,4996,4806,190,44,3692,5.499999999999998
2018-01-05 16:00:00,1,9836,9774,62,54,384,5.499999999999998
2018-01-05 16:00:00,2,8016,7884,132,19,350,5.499999999999998
2018-01-05 17:00:00,1,10056,10098,-42,26,420,5.499999999999998
2018-01-05 17:00:00,2,4797,4590,207,43,2566,5.499999999999998
2018-01-05 18:00:00,1,10152,10098,54,32,316,5.499999999999998
2018-01-05 18:00:00,2,8776,8694,82,18,604,5.499999999999998
2018-01-05 19:00:00,1,10044,9936,108,90,290,9.499999999999998
2018-01-05 19:00:00,2,6784,6804,-20,37,626,5.499999999999998
2018-01-05 20:00:00,1,9471,9396,75,49,344,5.499999999999998
2018-01-05 20:00:00,2,7800,7614,186,70,1354,5.499999999999998
2018-01-05 21:00:00,1,9724,9666,58,50,434,5.499999999999998
2018-01-05 21:00:00,2,9072,8856,216,73,1038,5.499999999999998
2018-01-05 22:00:00,1,9744,9612,132,77,418,5.499999999999998
2018-01-05 22:00:00,2,1686,2178,-492,54,728,5.499999999999998
2018-01-05 23:00:00,1,8756,8802,-46,35,506,4.999999999999998
2018-01-06 00:00:00,1,9192,9180,12,32,32686,4.999999999999998
2018-01-06 01:00:00,1,9974,9774,200,38,724,4.999999999999998
2018-01-06 02:00:00,1,9795,9774,21,37,628,4.999999999999998
2018-01-06 03:00:00,1,9199,9126,73,27,398,4.999999999999998
2018-01-06 04:00:00,1,8941,8802,139,49,428,4.999999999999998
2018-01-06 05:00:00,1,9019,9018,1,45,630,4.999999999999998
2018-01-06 06:00:00,1,9779,9612,167,49,710,4.999999999999998
2018-01-06 07:00:00,1,8950,9018,-68,32,648,7.999999999999998
2018-01-06 07:00:00,2,5534,4914,620,35,472,4.999999999999998
2018-01-06 08:00:00,1,8556,8424,132,44,666,4.999999999999998
2018-01-06 08:00:00,2,10088,10044,44,20,908,4.999999999999998
2018-01-06 09:00:00,1,8040,7938,102,33,834,4.999999999999998
2018-01-06 09:00:00,2,10628,10584,44,31,336,4.999999999999998
2018-01-06 10:00:00,1,7520,7560,-40,20,1176,4.999999999999998
2018-01-06 10:00:00,2,10372,10314,58,43,154,4.999999999999998
2018-01-06 11:00:00,1,9672,9450,222,59,1018,7.999999999999998
2018-01-06 11:00:00,2,10210,10098,112,27,266,4.999999999999998
2018-01-06 12:00:00,1,8204,8316,-112,42,444,4.999999999999998
2018-01-06 12:00:00,2,7834,7830,4,41,266,4.999999999999998
2018-01-06 13:00:00,1,10436,10260,176,37,906,4.999999999999998
2018-01-06 13:00:00,2,10764,10638,126,31,1066,4.999999999999998
2018-01-06 14:00:00,1,8767,8640,127,46,264,4.999999999999998
2018-01-06 14:00:00,2,5354,5832,-478,23,350,4.999999999999998
2018-01-06 15:00:00,1,5945,5886,59,36,990,4.999999999999998
2018-01-06 16:00:00,1,8596,8532,64,20,58206,4.999999999999998
2018-01-06 17:00:00,1,7914,7938,-24,31,1658,4.999999999999998
2018-01-06 18:00:00,1,7455,7344,111,18,654,4.999999999999998
2018-01-06 19:00:00,1,6120,6156,-36,39,1266,4.999999999999998
2018-01-06 20:00:00,1,9028,8910,118,37,1032,4.999999999999998
2018-01-06 21:00:00,1,3063,3186,-123,32,1566,4.999999999999998
2018-01-06 22:00:00,1,9095,8856,239,50,744,4.999999999999998
2018-01-06 23:00:00,1,10060,9936,124,29,2502,7.999999999999998
2018-01-07 00:00:00,1,5024,5508,-484,40,660,4.999999999999998
2018-01-07 01:00:00,1,6966,6318,648,31,360,4.999999999999998
2018-01-07 02:00:00,1,8999,8964,35,32,2726,4.999999999999998
2018-01-07 03:00:00,1,9440,9288,152,34,586,4.999999999999998
2018-01-07 04:00:00,1,8060,7884,176,49,640,4.999999999999998
2018-01-07 05:00:00,1,8403,8316,87,52,660,4.999999999999998
2018-01-07 06:00:00,1,7828,7830,-2,41,894,4.999999999999998
2018-01-07 06:00:00,2,2882,2268,614,72,838,7.999999999999998
2018-01-07 07:00:00,1,7900,7722,178,94,1038,4.999999999999998
2018-01-07 07:00:00,2,9892,9828,64,10,70,4.999999999999998
2018-01-07 08:00:00,1,9108,9018,90,94,966,4.999999999999998
2018-01-07 08:00:00,2,10512,10476,36,29,390,4.999999999999998
2018-01-07 09:00:00,1,8727,8694,33,89,588,4.999999999999998
2018-01-07 09:00:00,2,10652,10584,68,26,194,4.999999999999998
2018-01-07 10:00:00,1,8742,8748,-6,118,716,4.999999999999998
2018-01-07 10:00:00,2,9320,9504,-184,30,148,4.999999999999998
2018-01-07 11:00:00,1,10184,10044,140,116,696,8.999999999999998
2018-01-07 11:00:00,2,10344,10044,300,61,640,8.999999999999998
2018-01-07 12:00:00,1,9712,9666,46,32,290,8.999999999999998
2018-01-07 12:00:00,2,9956,9936,20,32,250,8.999999999999998
2018-01-07 13:00:00,1,9588,9558,30,20,594,8.999999999999998
2018-01-07 13:00:00,2,10412,10260,152,49,292,8.999999999999998
2018-01-07 14:00:00,1,10312,10206,106,28,364,8.999999999999998
2018-01-07 14:00:00,2,10344,10314,30,30,258,12.499999999999998
2018-01-07 15:00:00,1,6880,6804,76,49,236,8.999999999999998
2018-01-07 15:00:00,2,10064,9990,74,27,246,8.999999999999998
2018-01-07 16:00:00,1,9551,9558,-7,48,1356,8.999999999999998
2018-01-07 16:00:00,2,4190,4716,-526,23,386,8.999999999999998
2018-01-07 17:00:00,1,9368,9234,134,59,516,8.999999999999998
2018-01-07 17:00:00,2,7653,7020,633,46,3170,8.999999999999998
2018-01-07 18:00:00,1,7688,7722,-34,42,514,8.999999999999998
2018-01-07 18:00:00,2,7728,7722,6,21,168,12.499999999999998
2018-01-07 19:00:00,1,5100,5022,78,49,2988,8.999999999999998
2018-01-07 19:00:00,2,6948,6804,144,46,1082,8.999999999999998
2018-01-07 20:00:00,1,5479,5400,79,26,368,8.999999999999998
2018-01-07 20:00:00,2,10080,10044,36,33,1412,8.999999999999998
2018-01-07 21:00:00,1,7595,7614,-19,45,1794,8.999999999999998
2018-01-07 21:00:00,2,9248,9234,14,34,476,8.999999999999998
2018-01-07 22:00:00,1,6925,6804,121,59,1126,8.999999999999998
2018-01-07 22:00:00,2,10452,10368,84,40,494,8.999999999999998
2018-01-07 23:00:00,1,8088,8208,-120,81,1272,8.999999999999998
2018-01-07 23:00:00,2,9584,9504,80,23,214,8.999999999999998
2018-01-08 00:00:00,1,5546,5868,-322,42,1050,8.999999999999998
2018-01-08 00:00:00,2,10696,10638,58,79,496,8.999999999999998
2018-01-08 01:00:00,1,5506,4860,646,37,3212,8.999999999999998
2018-01-08 01:00:00,2,10316,10260,56,30,138,8.999999999999998
2018-01-08 02:00:00,1,9363,9288,75,28,294,8.999999999999998
2018-01-08 02:00:00,2,9448,9342,106,25,282,12.499999999999998
2018-01-08 03:00:00,1,8624,8424,200,49,522,8.999999999999998
2018-01-08 03:00:00,2,10160,10152,8,30,534,8.999999999999998
2018-01-08 04:00:00,1,8634,8478,156,68,834,8.999999999999998
2018-01-08 04:00:00,2,10696,10638,58,44,302,8.999999999999998
2018-01-08 05:00:00,1,6382,6426,-44,58,802,8.999999999999998
2018-01-08 05:00:00,2,10412,10368,44,31,144,8.999999999999998
2018-01-08 06:00:00,1,6784,6588,196,88,1576,8.999999999999998
2018-01-08 06:00:00,2,10848,10800,48,25,236,12.499999999999998
2018-01-08 07:00:00,1,8804,8640,164,36,1258,8.999999999999998
2018-01-08 07:00:00,2,10224,10206,18,25,92,8.999999999999998
2018-01-08 08:00:00,1,9324,9180,144,51,718,8.999999999999998
2018-01-08 08:00:00,2,10700,10638,62,33,280,8.999999999999998
2018-01-08 09:00:00,1,8920,8910,10,62,556,8.999999999999998
2018-01-08 09:00:00,2,10688,10584,104,55,142,8.999999999999998
2018-01-08 10:00:00,1,9176,8964,212,123,618,8.999999999999998
2018-01-08 10:00:00,2,10804,10746,58,31,164,8.999999999999998
2018-01-08 11:00:00,1,9388,9288,100,102,648,8.999999999999998
2018-01-08 11:00:00,2,9819,9666,153,30,224,8.999999999999998
2018-01-08 12:00:00,1,6698,6642,56,71,454,8.999999999999998
2018-01-08 12:00:00,2,10836,10800,36,28,312,8.999999999999998
2018-01-08 13:00:00,1,10095,10044,51,54,1402,8.999999999999998
2018-01-08 13:00:00,2,10472,10422,50,31,106,8.999999999999998
2018-01-08 14:00:00,1,8943,8802,141,62,324,8.999999999999998
2018-01-08 14:00:00,2,10915,10800,115,22,208,12.499999999999998
2018-01-08 15:00:00,1,9863,9720,143,53,674,8.999999999999998
2018-01-08 15:00:00,2,9918,9882,36,26,116,8.999999999999998
2018-01-08 16:00:00,1,7490,7974,-484,56,416,8.999999999999998
2018-01-08 16:00:00,2,2746,3294,-548,27,382,8.999999999999998
2018-01-08 17:00:00,1,94,0,94,69,4848,8.999999999999998
2018-01-08 17:00:00,2,4674,4050,624,13,4246,8.999999999999998
2018-01-08 18:00:00,1,5087,4698,389,11,578,8.999999999999998
2018-01-08 18:00:00,2,9900,9882,18,50,1802,12.499999999999998
2018-01-08 19:00:00,1,9530,9450,80,32,400,8.999999999999998
2018-01-08 19:00:00,2,8668,8586,82,50,466,8.999999999999998
2018-01-08 20:00:00,1,9436,9288,148,48,756,8.999999999999998
2018-01-08 20:00:00,2,8995,8910,85,65,528,8.999999999999998
2018-01-08 21:00:00,1,10376,10260,116,49,722,8.999999999999998
2018-01-08 21:00:00,2,4752,4698,54,68,236,8.999999999999998
2018-01-08 22:00:00,1,10096,10044,52,41,2078,8.999999999999998
2018-01-08 22:00:00,2,8948,8910,38,54,280,8.999999999999998
2018-01-08 23:00:00,1,8564,8586,-22,62,636,8.999999999999998
2018-01-08 23:00:00,2,10564,10530,34,63,802,8.999999999999998
2018-01-09 00:00:00,1,9801,9720,81,28,256,8.999999999999998
2018-01-09 00:00:00,2,10256,10152,104,42,612,8.999999999999998
2018-01-09 01:00:00,1,8720,8586,134,44,222,8.999999999999998
2018-01-09 01:00:00,2,10488,10476,12,40,584,8.999999999999998
2018-01-09 02:00:00,1,9963,9882,81,30,238,8.999999999999998
2018-01-09 02:00:00,2,9520,9396,124,28,364,12.499999999999998
2018-01-09 03:00:00,1,8088,7938,150,35,508,8.999999999999998
2018-01-09 03:00:00,2,6596,6588,8,59,908,8.999999999999998
2018-01-09 04:00:00,1,8072,8046,26,37,1864,8.999999999999998
2018-01-09 04:00:00,2,8344,8262,82,42,994,8.999999999999998
2018-01-09 05:00:00,1,7340,7290,50,26,542,8.999999999999998
2018-01-09 05:00:00,2,9935,9882,53,24,1340,8.999999999999998
2018-01-09 06:00:00,1,9199,9126,73,22,610,8.999999999999998
2018-01-09 06:00:00,2,6172,6102,70,37,560,12.499999999999998
2018-01-09 07:00:00,1,8916,8910,6,24,1490,8.999999999999998
2018-01-09 07:00:00,2,9240,9234,6,58,690,4.999999999999998
2018-01-09 08:00:00,1,8936,8856,80,46,514,4.999999999999998
2018-01-09 08:00:00,2,9584,9558,26,73,596,4.999999999999998
2018-01-09 09:00:00,1,7980,7830,150,42,480,4.999999999999998
2018-01-09 09:00:00,2,8116,8208,-92,42,1190,4.999999999999998
2018-01-09 10:00:00,1,4476,4482,-6,25,1112,4.999999999999998
2018-01-09 10:00:00,2,8056,7830,226,23,2010,4.999999999999998
2018-01-09 11:00:00,1,9792,9666,126,37,886,4.999999999999998
2018-01-09 11:00:00,2,10416,10422,-6,38,370,4.999999999999998
2018-01-09 12:00:00,1,5893,6372,-479,33,188,9.999999999999998
2018-01-09 12:00:00,2,10684,10530,154,47,3302,9.999999999999998
2018-01-09 13:00:00,1,5113,4644,469,35,176,9.999999999999998
2018-01-09 13:00:00,2,9317,9288,29,16,286,9.999999999999998
2018-01-09 14:00:00,1,10143,9990,153,46,570,9.999999999999998
2018-01-09 14:00:00,2,8916,8856,60,35,322,13.999999999999998
2018-01-09 15:00:00,1,9276,9234,42,47,716,9.999999999999998
2018-01-09 15:00:00,2,10308,10206,102,59,588,9.999999999999998
2018-01-09 16:00:00,1,9684,9612,72,28,274,9.999999999999998
2018-01-09 16:00:00,2,8644,8694,-50,42,458,9.999999999999998
2018-01-09 17:00:00,1,8366,8316,50,87,858,9.999999999999998
2018-01-09 17:00:00,2,7628,7344,284,71,922,9.999999999999998
2018-01-09 18:00:00,1,9112,9018,94,39,1036,9.999999999999998
2018-01-09 18:00:00,2,9159,9126,33,70,680,13.999999999999998
2018-01-09 19:00:00,1,8578,8586,-8,51,640,13.999999999999998
2018-01-09 19:00:00,2,8470,8982,-512,33,704,12.999999999999998
2018-01-09 20:00:00,1,8399,8316,83,28,4806,12.999999999999998
2018-01-09 21:00:00,1,9132,9072,60,33,868,12.999999999999998
2018-01-09 21:00:00,2,8434,7884,550,36,642,12.999999999999998
2018-01-09 22:00:00,1,9376,9342,34,68,502,12.999999999999998
2018-01-09 22:00:00,2,9368,9234,134,53,558,12.999999999999998
2018-01-09 23:00:00,1,8824,8694,130,43,594,12.999999999999998
2018-01-09 23:00:00,2,9110,9072,38,72,724,12.999999999999998
2018-01-10 00:00:00,1,8868,8856,12,48,616,12.999999999999998
2018-01-10 00:00:00,2,8396,8370,26,61,730,12.999999999999998
2018-01-10 01:00:00,1,8956,8892,64,38,904,12.999999999999998
2018-01-10 01:00:00,2,8296,8262,34,53,674,12.999999999999998
2018-01-10 02:00:00,1,9924,9882,42,46,916,12.999999999999998
2018-01-10 02:00:00,2,9796,9666,130,35,392,12.999999999999998
2018-01-10 03:00:00,1,9448,9342,106,47,484,15.999999999999998
2018-01-10 03:00:00,2,9976,9936,40,62,512,12.999999999999998
2018-01-10 04:00:00,1,9196,9180,16,39,332,12.999999999999998
2018-01-10 04:00:00,2,8014,8046,-32,52,656,12.999999999999998
2018-01-10 05:00:00,1,6211,6102,109,62,972,12.999999999999998
2018-01-10 05:00:00,2,9716,9612,104,36,1538,12.999999999999998
2018-01-10 06:00:00,1,8980,9018,-38,38,556,12.999999999999998
2018-01-10 06:00:00,2,9428,9342,86,63,650,12.999999999999998
2018-01-10 07:00:00,1,8812,8748,64,39,492,13.999999999999998
2018-01-10 07:00:00,2,9398,9288,110,65,724,9.999999999999998
2018-01-10 08:00:00,1,8340,8262,78,37,698,9.999999999999998
2018-01-10 08:00:00,2,6613,6588,25,80,868,9.999999999999998
2018-01-10 09:00:00,1,8584,8532,52,75,1316,9.999999999999998
2018-01-10 09:00:00,2,8331,8262,69,65,792,9.999999999999998
2018-01-10 10:00:00,1,7650,7560,90,43,890,9.999999999999998
2018-01-10 10:00:00,2,10264,10206,58,57,1110,9.999999999999998
2018-01-10 11:00:00,1,7092,7236,-144,34,286,9.999999999999998
2018-01-10 11:00:00,2,7116,7128,-12,27,1340,9.999999999999998
2018-01-10 12:00:00,1,9003,8694,309,39,1288,9.999999999999998
2018-01-10 12:00:00,2,9096,9018,78,77,656,9.999999999999998
2018-01-10 13:00:00,1,8700,8694,6,36,670,9.999999999999998
2018-01-10 13:00:00,2,10055,9936,119,79,714,9.999999999999998
2018-01-10 14:00:00,1,9520,9396,124,40,342,9.999999999999998
2018-01-10 14:00:00,2,9793,9720,73,57,538,9.999999999999998
2018-01-10 15:00:00,1,7669,7668,1,94,436,13.999999999999998
2018-01-10 15:00:00,2,4571,4752,-181,88,1254,9.999999999999998
2018-01-10 16:00:00,1,6993,6912,81,43,2182,9.999999999999998
2018-01-10 16:00:00,2,8852,8532,320,53,1110,9.999999999999998
2018-01-10 17:00:00,1,4572,4644,-72,49,622,9.999999999999998
2018-01-10 17:00:00,2,8780,8694,86,47,2094,9.999999999999998
2018-01-10 18:00:00,1,7919,7830,89,93,748,9.999999999999998
2018-01-10 18:00:00,2,9872,9936,-64,64,1042,9.999999999999998
2018-01-10 19:00:00,1,7561,7506,55,33,420,13.999999999999998
2018-01-10 19:00:00,2,10500,10368,132,44,1094,9.999999999999998
2018-01-10 20:00:00,1,4312,4374,-62,33,206,9.999999999999998
2018-01-10 20:00:00,2,9740,9666,74,52,4720,9.999999999999998
2018-01-10 21:00:00,1,620,486,134,79,464,9.999999999999998
2018-01-10 21:00:00,2,9712,9666,46,9,858,9.999999999999998
2018-01-10 22:00:00,1,8936,8856,80,33,520,9.999999999999998
2018-01-10 22:00:00,2,9220,9180,40,82,682,9.999999999999998
2018-01-10 23:00:00,1,9676,9720,-44,41,526,9.999999999999998
2018-01-10 23:00:00,2,10460,10422,38,93,438,9.999999999999998
2018-01-11 00:00:00,1,4690,5148,-458,44,212,9.999999999999998
2018-01-11 00:00:00,2,9724,9666,58,50,3756,9.999999999999998
2018-01-11 01:00:00,1,5394,4860,534,70,446,9.999999999999998
2018-01-11 01:00:00,2,7896,7830,66,43,156,9.999999999999998
2018-01-11 02:00:00,1,9056,9018,38,104,1028,9.999999999999998
2018-01-11 02:00:00,2,9836,9828,8,68,674,9.999999999999998
2018-01-11 03:00:00,1,9363,9234,129,62,424,13.999999999999998
2018-01-11 03:00:00,2,10408,10260,148,89,472,9.999999999999998
2018-01-11 04:00:00,1,9256,9180,76,44,256,9.999999999999998
2018-01-11 04:00:00,2,9932,10044,-112,102,570,9.999999999999998
2018-01-11 05:00:00,1,4466,4428,38,62,408,9.999999999999998
2018-01-11 05:00:00,2,9130,9018,112,64,2152,9.999999999999998
2018-01-11 06:00:00,1,7256,7236,20,51,604,9.999999999999998
2018-01-11 06:00:00,2,9920,9774,146,123,1106,9.999999999999998
2018-01-11 07:00:00,1,4232,4212,20,131,406,13.999999999999998
2018-01-11 07:00:00,2,5671,6174,-503,69,2636,9.999999999999998
2018-01-11 08:00:00,1,4984,4914,70,84,3452,9.999999999999998
2018-01-11 08:00:00,2,386,0,386,94,1900,9.999999999999998
2018-01-11 09:00:00,1,3378,3294,84,1,2050,9.999999999999998
2018-01-11 09:00:00,2,8132,7830,302,68,2080,9.999999999999998
2018-01-11 10:00:00,1,6012,5994,18,29,680,9.999999999999998
2018-01-11 10:00:00,2,10020,9882,138,102,1670,9.999999999999998
2018-01-11 11:00:00,1,3996,3942,54,36,316,9.999999999999998
2018-01-11 11:00:00,2,9036,9126,-90,53,2814,9.999999999999998
2018-01-11 12:00:00,1,4364,4320,44,49,638,10.999999999999998
2018-01-11 12:00:00,2,5585,5868,-283,69,1830,10.999999999999998
2018-01-11 13:00:00,1,6609,6588,21,24,4770,10.999999999999998
2018-01-11 13:00:00,2,1510,1026,484,46,1330,10.999999999999998
2018-01-11 14:00:00,1,7660,7560,100,4,14,10.999999999999998
2018-01-11 14:00:00,2,9852,9774,78,67,1082,10.999999999999998
2018-01-11 15:00:00,1,9516,9504,12,30,412,9.999999999999998
2018-01-11 15:00:00,2,10428,10260,168,40,576,9.999999999999998
2018-01-11 16:00:00,1,5040,5022,18,29,270,9.999999999999998
2018-01-11 16:00:00,2,9376,9396,-20,53,2010,9.999999999999998
2018-01-11 17:00:00,1,5424,5346,78,62,536,9.999999999999998
2018-01-11 17:00:00,2,8120,8100,20,72,1916,9.999999999999998
2018-01-11 18:00:00,1,5935,5886,49,54,964,9.999999999999998
2018-01-11 18:00:00,2,9900,9720,180,92,1508,9.999999999999998
2018-01-11 19:00:00,1,5551,5562,-11,33,442,12.999999999999998
2018-01-11 19:00:00,2,9398,9396,2,116,4960,9.999999999999998
2018-01-11 20:00:00,1,164,108,56,39,568,9.999999999999998
2018-01-11 20:00:00,2,7784,7830,-46,2,412,9.999999999999998
2018-01-11 21:00:00,1,9044,8964,80,40,1062,9.999999999999998
2018-01-11 21:00:00,2,8830,8586,244,37,532,9.999999999999998
2018-01-11 22:00:00,1,9266,9234,32,30,774,9.999999999999998
2018-01-11 22:00:00,2,9060,8964,96,45,538,9.999999999999998
2018-01-11 23:00:00,1,7352,7398,-46,50,670,9.999999999999998
2018-01-11 23:00:00,2,8784,8856,-72,63,1222,9.999999999999998
2018-01-12 00:00:00,1,8236,8046,190,33,1326,9.999999999999998
2018-01-12 00:00:00,2,3772,3726,46,103,934,9.999999999999998
2018-01-12 01:00:00,1,6624,6534,90,103,1910,9.999999999999998
2018-01-12 01:00:00,2,5980,5778,202,60,1426,9.999999999999998
2018-01-12 02:00:00,1,7339,7236,103,39,1514,9.999999999999998
2018-01-12 02:00:00,2,9980,9936,44,69,1148,9.999999999999998
2018-01-12 03:00:00,1,8431,8424,7,27,492,12.999999999999998
2018-01-12 03:00:00,2,9968,10098,-130,51,794,9.999999999999998
2018-01-12 04:00:00,1,5096,5076,20,29,290,9.999999999999998
2018-01-12 04:00:00,2,9480,9234,246,46,2236,9.999999999999998
2018-01-12 05:00:00,1,7732,7614,118,67,498,9.999999999999998
2018-01-12 05:00:00,2,10296,10260,36,43,796,9.999999999999998
2018-01-12 06:00:00,1,7887,7830,57,34,280,9.999999999999998
2018-01-12 06:00:00,2,10340,10314,26,61,1140,9.999999999999998
2018-01-12 07:00:00,1,5692,5670,22,43,258,12.999999999999998
2018-01-12 07:00:00,2,10172,10152,20,43,1632,9.999999999999998
2018-01-12 08:00:00,1,8980,8910,70,31,288,9.999999999999998
2018-01-12 08:00:00,2,10116,9990,126,39,664,9.999999999999998
2018-01-12 09:00:00,1,9482,9396,86,69,372,9.999999999999998
2018-01-12 09:00:00,2,9076,8964,112,60,542,9.999999999999998
2018-01-12 10:00:00,1,4556,4536,20,53,638,9.999999999999998
2018-01-12 10:00:00,2,1476,1512,-36,33,4314,9.999999999999998
2018-01-12 11:00:00,1,2968,2916,52,7,3398,9.999999999999998
2018-01-12 11:00:00,2,4692,4698,-6,14,8406,9.999999999999998
2018-01-12 12:00:00,2,1987,2160,-173,30,2194,9.999999999999998
2018-01-12 14:00:00,1,0,108,-108,11,17876,9.999999999999998
2018-01-12 17:00:00,2,5664,5400,264,2,18356,9.999999999999998
2018-01-12 18:00:00,2,10188,10098,90,35,1002,9.999999999999998
2018-01-12 19:00:00,1,7096,6912,184,29,308,9.999999999999998
2018-01-12 19:00:00,2,9932,9828,104,35,314,9.999999999999998
2018-01-12 20:00:00,1,8186,8154,32,43,392,12.999999999999998
2018-01-12 20:00:00,2,6556,6570,-14,40,1016,9.999999999999998
2018-01-12 21:00:00,1,8232,8100,132,19,1496,9.999999999999998
2018-01-12 21:00:00,2,9076,9558,-482,66,882,9.999999999999998
2018-01-12 22:00:00,1,8319,8208,111,79,848,10.999999999999998
2018-01-12 23:00:00,1,8971,9018,-47,84,866,10.999999999999998
2018-01-13 00:00:00,1,8992,8856,136,3,26658,10.999999999999998
2018-01-13 01:00:00,1,9460,9396,64,50,648,10.999999999999998
2018-01-13 02:00:00,1,4716,5184,-468,48,698,12.999999999999998
2018-01-13 03:00:00,1,6948,6372,576,38,536,10.999999999999998
2018-01-13 04:00:00,1,9418,9342,76,32,2940,10.999999999999998
2018-01-13 05:00:00,1,8363,8262,101,29,406,10.999999999999998
2018-01-13 06:00:00,1,7852,7938,-86,61,542,10.999999999999998
2018-01-13 07:00:00,1,6852,6588,264,53,882,10.999999999999998
2018-01-13 08:00:00,1,7004,6966,38,1,34200,10.999999999999998
2018-01-13 09:00:00,1,9492,9396,96,71,1090,10.999999999999998
2018-01-13 10:00:00,1,9928,9882,46,58,1404,10.999999999999998
2018-01-13 11:00:00,1,8675,8586,89,84,1208,10.999999999999998
2018-01-13 12:00:00,1,9670,9558,112,60,472,10.999999999999998
2018-01-13 13:00:00,1,9196,9126,70,41,556,10.999999999999998
2018-01-13 14:00:00,1,9199,9072,127,54,578,10.999999999999998
2018-01-13 15:00:00,1,9808,9828,-20,48,456,10.999999999999998
2018-01-13 16:00:00,1,10256,10098,158,52,620,10.999999999999998
2018-01-13 17:00:00,1,10160,10098,62,48,626,10.999999999999998
2018-01-13 18:00:00,1,9832,9828,4,29,390,12.999999999999998
2018-01-13 19:00:00,1,10080,9936,144,1,61058,10.999999999999998
2018-01-13 20:00:00,1,9980,9990,-10,43,290,10.999999999999998
2018-01-13 21:00:00,1,10025,9882,143,48,292,10.999999999999998
2018-01-13 22:00:00,1,9955,9990,-35,43,414,10.999999999999998
2018-01-13 23:00:00,1,9876,9720,156,34,332,10.999999999999998
2018-01-14 00:00:00,1,9654,9612,42,28,382,10.999999999999998
2018-01-14 01:00:00,1,9976,9882,94,35,354,9.999999999999998
2018-01-14 02:00:00,1,8664,8532,132,35,412,12.999999999999998
2018-01-14 03:00:00,1,9624,9612,12,46,404,9.999999999999998
2018-01-14 04:00:00,1,9396,9342,54,50,434,9.999999999999998
2018-01-14 05:00:00,1,9744,9720,24,46,424,9.999999999999998
2018-01-14 06:00:00,1,10404,10260,144,46,748,9.999999999999998
2018-01-14 07:00:00,1,9883,9828,55,34,446,9.999999999999998
2018-01-14 07:00:00,2,670,108,562,59,538,9.999999999999998
2018-01-14 08:00:00,1,9369,9342,27,36,424,9.999999999999998
2018-01-14 08:00:00,2,9147,9018,129,23,266,9.999999999999998
2018-01-14 09:00:00,1,8251,8208,43,27,406,9.999999999999998
2018-01-14 09:00:00,2,6824,6858,-34,1,62,9.999999999999998
2018-01-14 10:00:00,1,8191,8100,91,56,532,9.999999999999998
2018-01-14 10:00:00,2,10019,9936,83,29,592,9.999999999999998
2018-01-14 11:00:00,1,4508,4950,-442,87,936,9.999999999999998
2018-01-14 11:00:00,2,10319,10314,5,29,1372,9.999999999999998
2018-01-14 12:00:00,1,2218,1620,598,49,874,9.999999999999998
2018-01-14 12:00:00,2,9756,9558,198,38,366,12.999999999999998
2018-01-14 13:00:00,1,9456,9342,114,65,5004,9.999999999999998
2018-01-14 13:00:00,2,9614,9558,56,39,252,9.999999999999998
2018-01-14 14:00:00,1,9551,9396,155,5,58,9.999999999999998
2018-01-14 14:00:00,2,10644,10584,60,34,490,9.999999999999998
2018-01-14 15:00:00,1,10496,10368,128,73,512,9.999999999999998
2018-01-14 15:00:00,2,9047,8964,83,90,422,9.999999999999998
2018-01-14 16:00:00,1,9776,9666,110,69,470,9.999999999999998
2018-01-14 16:00:00,2,9206,9234,-28,30,240,12.999999999999998
2018-01-14 17:00:00,1,9542,9558,-16,62,152,9.999999999999998
2018-01-14 17:00:00,2,9023,8856,167,32,596,9.999999999999998
2018-01-14 18:00:00,1,10203,10044,159,49,414,9.999999999999998
2018-01-14 18:00:00,2,8675,8586,89,63,650,9.999999999999998
2018-01-14 19:00:00,1,10394,10368,26,58,454,9.999999999999998
2018-01-14 19:00:00,2,9244,9180,64,72,626,9.999999999999998
2018-01-14 20:00:00,1,9546,9504,42,46,304,9.999999999999998
2018-01-14 20:00:00,2,7708,7776,-68,58,824,9.999999999999998
2018-01-14 21:00:00,1,9223,8946,277,52,170,9.999999999999998
2018-01-14 21:00:00,2,8162,7938,224,71,564,9.999999999999998
2018-01-14 22:00:00,1,9325,9558,-233,68,620,9.999999999999998
2018-01-14 22:00:00,2,8909,8910,-1,49,1214,9.999999999999998
2018-01-14 23:00:00,1,2330,1926,404,69,438,9.999999999999998
2018-01-14 23:00:00,2,9780,9558,222,66,824,9.999999999999998
2018-01-15 00:00:00,1,9244,9180,64,53,538,9.999999999999998
2018-01-15 00:00:00,2,5554,5562,-8,88,696,12.999999999999998
2018-01-15 01:00:00,1,9628,9774,-146,19,2878,13.999999999999998
2018-01-15 01:00:00,2,1711,1512,199,51,482,13.999999999999998
2018-01-15 02:00:00,1,5719,5562,157,47,566,13.999999999999998
2018-01-15 02:00:00,2,8952,8856,96,50,3726,13.999999999999998
2018-01-15 03:00:00,1,9380,9234,146,50,582,13.999999999999998
2018-01-15 03:00:00,2,9971,9936,35,21,1390,13.999999999999998
2018-01-15 04:00:00,1,9087,9018,69,55,1620,13.999999999999998
2018-01-15 04:00:00,2,9332,9234,98,32,354,18.0
2018-01-15 05:00:00,1,9123,9126,-3,88,554,14.0
2018-01-15 05:00:00,2,9052,9018,34,40,592,14.0
2018-01-15 06:00:00,1,9440,9396,44,40,640,14.0
2018-01-15 06:00:00,2,10172,10098,74,39,376,14.0
2018-01-15 07:00:00,1,9595,9450,145,32,628,14.0
2018-01-15 07:00:00,2,10108,10044,64,61,676,14.0
2018-01-15 08:00:00,1,9953,9882,71,28,546,14.0
2018-01-15 08:00:00,2,2154,2718,-564,64,294,14.0
2018-01-15 09:00:00,1,9227,9234,-7,45,504,14.0
2018-01-15 09:00:00,2,5874,5238,636,59,326,14.0
2018-01-15 10:00:00,1,10164,10044,120,38,452,14.0
2018-01-15 10:00:00,2,10220,10260,-40,38,4372,14.0
2018-01-15 11:00:00,1,10351,10260,91,42,510,14.0
2018-01-15 11:00:00,2,9560,9450,110,23,232,14.0
2018-01-15 12:00:00,1,9408,9450,-42,89,326,14.0
2018-01-15 12:00:00,2,10016,10044,-28,34,266,18.0
2018-01-15 13:00:00,1,10648,10530,118,28,274,14.0
2018-01-15 13:00:00,2,9932,9828,104,39,520,14.0
2018-01-15 14:00:00,1,10347,10314,33,52,488,14.0
2018-01-15 14:00:00,2,9601,9612,-11,38,354,14.0
2018-01-15 15:00:00,1,10884,10800,84,29,190,14.0
2018-01-15 15:00:00,2,9476,9342,134,53,418,14.0
2018-01-15 16:00:00,1,9900,9882,18,20,262,14.0
2018-01-15 16:00:00,2,9580,9612,-32,48,490,18.0
2018-01-15 17:00:00,1,10164,10098,66,10,86,14.0
2018-01-15 17:00:00,2,8656,8478,178,43,550,14.0
2018-01-15 18:00:00,1,9392,9342,50,43,396,14.0
2018-01-15 18:00:00,2,9171,9126,45,91,494,14.0
2018-01-15 19:00:00,1,9192,9180,12,33,314,14.0
2018-01-15 19:00:00,2,8648,8694,-46,74,812,14.0
2018-01-15 20:00:00,1,3583,3564,19,53,550,14.0
2018-01-15 20:00:00,2,3364,3294,70,54,632,13.5
2018-01-15 21:00:00,1,4523,4482,41,81,586,13.5
2018-01-15 21:00:00,2,4376,4482,-106,80,808,13.5
2018-01-15 22:00:00,1,6076,6048,28,20,3498,13.5
2018-01-15 22:00:00,2,4708,4536,172,40,4010,13.5
2018-01-15 23:00:00,1,7572,7506,66,40,1310,13.5
2018-01-15 23:00:00,2,4704,4644,60,44,664,13.5
2018-01-16 00:00:00,1,9083,9072,11,39,2040,13.5
2018-01-16 00:00:00,2,8328,8262,66,27,2368,16.5
2018-01-16 01:00:00,1,9027,9072,-45,47,528,13.5
2018-01-16 01:00:00,2,10444,10368,76,50,1820,13.5
2018-01-16 02:00:00,1,8856,8748,108,48,626,13.5
2018-01-16 02:00:00,2,10056,9990,66,61,892,13.5
2018-01-16 03:00:00,1,8484,8424,60,59,656,13.5
2018-01-16 03:00:00,2,10168,10098,70,46,242,13.5
2018-01-16 04:00:00,1,9487,9558,-71,47,730,13.5
2018-01-16 04:00:00,2,9860,9828,32,46,356,16.5
2018-01-16 05:00:00,1,8015,7830,185,57,856,13.5
2018-01-16 05:00:00,2,9301,9180,121,52,316,13.5
2018-01-16 06:00:00,1,8657,8640,17,66,630,13.5
2018-01-16 06:00:00,2,9587,9558,29,99,394,13.5
2018-01-16 07:00:00,1,8723,8694,29,98,1056,13.5
2018-01-16 07:00:00,2,8512,8532,-20,61,604,13.5
2018-01-16 08:00:00,1,9635,9558,77,80,596,13.5
2018-01-16 08:00:00,2,8158,7992,166,91,494,13.5
2018-01-16 09:00:00,1,2480,2430,50,77,740,13.5
2018-01-16 09:00:00,2,7026,6912,114,72,982,13.5
2018-01-16 10:00:00,1,10507,10476,31,85,1322,13.5
2018-01-16 10:00:00,2,8740,8856,-116,99,836,13.5
2018-01-16 11:00:00,1,9916,9882,34,24,1990,13.5
2018-01-16 11:00:00,2,8190,7992,198,73,1338,13.5
2018-01-16 12:00:00,1,2691,3168,-477,46,126,13.5
2018-01-16 12:00:00,2,7007,6858,149,68,672,16.5
2018-01-16 13:00:00,1,1690,1080,610,67,512,13.5
2018-01-16 13:00:00,2,6495,6480,15,57,990,13.5
2018-01-16 14:00:00,1,5680,5454,226,29,4260,13.5
2018-01-16 14:00:00,2,10008,9882,126,56,1320,13.5
2018-01-16 15:00:00,1,4664,4482,182,22,1400,13.5
2018-01-16 15:00:00,2,8948,9072,-124,69,1476,13.5
2018-01-16 16:00:00,1,1670,2196,-526,34,1586,13.5
2018-01-16 16:00:00,2,9420,9180,240,51,314,16.5
2018-01-16 17:00:00,1,2350,1782,568,31,2086,13.5
2018-01-16 17:00:00,2,9323,9288,35,69,726,13.5
2018-01-16 18:00:00,1,3940,3996,-56,78,5578,13.5
2018-01-16 18:00:00,2,7853,7884,-31,87,496,13.5
2018-01-16 19:00:00,1,9194,9072,122,24,114,13.5
2018-01-16 19:00:00,2,5850,6210,-360,81,586,13.5
2018-01-16 20:00:00,1,4078,3942,136,59,2278,13.5
2018-01-16 20:00:00,2,1182,594,588,66,1196,13.5
2018-01-16 21:00:00,1,9472,9396,76,81,630,13.5
2018-01-16 21:00:00,2,8864,8802,62,79,1564,13.5
2018-01-16 22:00:00,1,8605,8532,73,71,2272,13.5
2018-01-16 22:00:00,2,8424,8424,0,8,3184,13.5
2018-01-16 23:00:00,1,7039,7236,-197,61,472,13.5
2018-01-16 23:00:00,2,7684,7614,70,62,740,13.5
2018-01-17 00:00:00,1,7809,7506,303,70,904,13.5
2018-01-17 00:00:00,2,9664,9612,52,75,814,16.5
2018-01-17 01:00:00,1,7554,7560,-6,60,1192,13.5
2018-01-17 01:00:00,2,10522,10368,154,151,1068,14.5
2018-01-17 02:00:00,1,7187,7074,113,87,1026,14.5
2018-01-17 02:00:00,2,9439,9396,43,24,474,14.5
2018-01-17 03:00:00,2,20,54,-34,89,1182,13.5
2018-01-17 07:00:00,1,5012,5022,-10,21,208,13.5
2018-01-17 07:00:00,2,5576,5508,68,62,17412,13.5
2018-01-17 08:00:00,1,9192,9126,66,60,16610,16.5
2018-01-17 08:00:00,2,10024,9936,88,45,236,13.5
2018-01-17 09:00:00,1,9392,9288,104,16,142,13.5
2018-01-17 09:00:00,2,10532,10476,56,106,542,13.5
2018-01-17 10:00:00,1,9258,9180,78,35,366,13.5
2018-01-17 10:00:00,2,10316,10368,-52,77,532,13.5
2018-01-17 11:00:00,1,9454,9450,4,28,188,13.5
2018-01-17 11:00:00,2,9864,9666,198,53,552,13.5
2018-01-17 12:00:00,1,8510,8532,-22,28,238,13.0
2018-01-17 12:00:00,2,10596,10584,12,78,492,13.0
2018-01-17 13:00:00,1,9832,9720,112,47,440,13.0
2018-01-17 13:00:00,2,10240,10098,142,103,830,15.0
2018-01-17 14:00:00,1,8339,8208,131,22,170,15.0
2018-01-17 14:00:00,2,10511,10368,143,64,360,15.0
2018-01-17 15:00:00,1,7788,7938,-150,25,288,15.0
2018-01-17 15:00:00,2,7891,7938,-47,93,878,15.0
2018-01-17 16:00:00,1,8330,8154,176,17,222,19.0
2018-01-17 16:00:00,2,8845,8586,259,51,1222,15.0
2018-01-17 17:00:00,1,9683,9558,125,25,1402,15.0
2018-01-17 17:00:00,2,10128,9990,138,89,730,15.0
2018-01-17 18:00:00,1,10022,9936,86,26,414,15.0
2018-01-17 18:00:00,2,10316,10206,110,59,468,15.0
2018-01-17 19:00:00,1,8372,8316,56,35,350,15.0
2018-01-17 19:00:00,2,9964,9882,82,70,312,15.0
2018-01-17 20:00:00,1,8631,8532,99,28,242,14.0
2018-01-17 20:00:00,2,6028,5886,142,68,870,11.0
2018-01-17 21:00:00,1,9556,9720,-164,28,538,11.0
2018-01-17 21:00:00,2,10300,10206,94,99,736,11.0
2018-01-17 22:00:00,1,9708,9450,258,25,1476,11.0
2018-01-17 22:00:00,2,6136,6156,-20,57,506,11.0
2018-01-17 23:00:00,1,1280,1134,146,23,272,11.0
2018-01-17 23:00:00,2,308,108,200,52,530,11.0
2018-01-18 00:00:00,1,924,1080,-156,70,5908,11.0
2018-01-18 00:00:00,2,540,648,-108,9,4198,11.0
2018-01-18 01:00:00,1,8939,9018,-79,8,2224,11.0
2018-01-18 01:00:00,2,9819,9828,-9,6,2666,11.0
2018-01-18 02:00:00,1,6544,6372,172,75,678,12.0
2018-01-18 02:00:00,2,8204,8154,50,31,394,12.0
2018-01-18 03:00:00,1,8520,8478,42,99,1726,12.0
2018-01-18 03:00:00,2,8697,8640,57,110,1044,12.0
2018-01-18 04:00:00,1,4807,4752,55,62,512,16.0
2018-01-18 04:00:00,2,1136,1188,-52,33,630,12.0
2018-01-18 05:00:00,1,9188,9180,8,46,2088,12.0
2018-01-18 05:00:00,2,9616,9342,274,11,3204,12.0
2018-01-18 06:00:00,1,7111,7020,91,98,496,12.0
2018-01-18 06:00:00,2,6364,6210,154,39,464,12.0
2018-01-18 07:00:00,1,9071,8910,161,95,1260,12.0
2018-01-18 08:00:00,1,9560,9450,110,28,31068,12.0
2018-01-18 09:00:00,1,9171,9018,153,44,614,10.0
2018-01-18 10:00:00,1,4164,4608,-444,50,508,11.0
2018-01-18 11:00:00,1,142,0,142,63,692,11.0
2018-01-18 14:00:00,1,1826,1242,584,30,3810,11.0
2018-01-18 15:00:00,1,8543,8262,281,2,1902,11.0
2018-01-18 15:00:00,2,6416,6480,-64,1,7234,11.0
2018-01-18 16:00:00,1,8831,8802,29,7,2978,11.0
2018-01-18 16:00:00,2,10136,9936,200,46,772,11.0
2018-01-18 17:00:00,1,9962,9774,188,58,854,11.0
2018-01-18 17:00:00,2,10292,10206,86,39,712,11.0
2018-01-18 18:00:00,1,9216,9180,36,38,260,11.0
2018-01-18 18:00:00,2,6736,6696,40,37,410,11.0
2018-01-18 19:00:00,1,9727,9558,169,29,288,11.0
2018-01-18 19:00:00,2,9384,9288,96,39,694,11.0
2018-01-18 20:00:00,1,8586,8532,54,30,1392,11.0
2018-01-18 20:00:00,2,10199,10098,101,42,302,11.0
2018-01-18 21:00:00,1,9582,9450,132,36,590,13.5
2018-01-18 21:00:00,2,10308,10152,156,70,754,11.0
2018-01-18 22:00:00,1,9289,9072,217,26,276,11.0
2018-01-18 22:00:00,2,9876,9828,48,63,494,11.0
2018-01-18 23:00:00,1,8726,8856,-130,37,284,11.0
2018-01-18 23:00:00,2,10022,9936,86,55,604,11.0
2018-01-19 00:00:00,1,9471,9234,237,45,460,11.0
2018-01-19 00:00:00,2,9992,9936,56,59,788,11.0
2018-01-19 01:00:00,1,10387,10260,127,35,286,13.5
2018-01-19 01:00:00,2,8444,8316,128,45,458,11.0
2018-01-19 02:00:00,1,6396,6858,-462,45,356,11.0
2018-01-19 02:00:00,2,8088,7992,96,43,244,11.0
2018-01-19 03:00:00,1,5239,4644,595,48,932,11.0
2018-01-19 03:00:00,2,10368,10314,54,36,2256,11.0
2018-01-19 04:00:00,1,9450,9288,162,63,902,11.0
2018-01-19 04:00:00,2,10508,10422,86,16,1166,11.0
2018-01-19 05:00:00,1,9243,9180,63,36,312,11.0
2018-01-19 05:00:00,2,10248,10152,96,64,526,11.0
2018-01-19 06:00:00,1,7880,7938,-58,22,136,11.0
2018-01-19 06:00:00,2,7382,7884,-502,17,634,11.0
2018-01-19 07:00:00,1,7138,7074,64,41,326,11.0
2018-01-19 07:00:00,2,1930,1350,580,85,1212,11.0
2018-01-19 08:00:00,1,6718,6426,292,24,2702,11.0
2018-01-19 08:00:00,2,9975,9882,93,46,1568,11.0
2018-01-19 09:00:00,1,8819,8856,-37,9,1476,13.5
2018-01-19 09:00:00,2,10365,10314,51,48,830,11.0
2018-01-19 10:00:00,1,10480,10314,166,63,328,11.0
2018-01-19 10:00:00,2,10209,10098,111,138,676,11.0
2018-01-19 11:00:00,1,10044,9936,108,26,248,11.0
2018-01-19 11:00:00,2,8660,8586,74,27,212,11.0
2018-01-19 12:00:00,1,7707,7614,93,35,298,11.0
2018-01-19 12:00:00,2,10122,10098,24,59,398,11.0
2018-01-19 13:00:00,1,6419,6318,101,21,800,13.5
2018-01-19 13:00:00,2,10378,10314,64,25,1070,11.0
2018-01-19 14:00:00,1,7240,7128,112,31,380,11.0
2018-01-19 14:00:00,2,9128,9072,56,36,1622,11.0
2018-01-19 15:00:00,1,9806,9774,32,18,184,11.0
2018-01-19 15:00:00,2,10535,10422,113,74,1148,11.0
2018-01-19 16:00:00,1,8260,8154,106,37,632,11.0
2018-01-19 16:00:00,2,10052,9936,116,41,418,11.0
2018-01-19 17:00:00,1,8636,8694,-58,37,204,11.0
2018-01-19 17:00:00,2,9808,9720,88,55,916,11.0
2018-01-19 18:00:00,1,8108,7938,170,42,344,11.0
2018-01-19 18:00:00,2,8923,8910,13,126,792,11.0
2018-01-19 19:00:00,1,8059,8046,13,42,488,11.0
2018-01-19 19:00:00,2,8491,8370,121,41,914,11.0
2018-01-19 20:00:00,1,10016,9828,188,41,608,11.0
2018-01-19 20:00:00,2,7575,7506,69,83,944,11.0
2018-01-19 21:00:00,1,1286,1350,-64,34,868,13.5
2018-01-19 21:00:00,2,2592,2538,54,86,344,11.0
2018-01-19 22:00:00,1,6667,6750,-83,26,3638,11.0
2018-01-19 22:00:00,2,7886,7830,56,16,3244,11.0
2018-01-19 23:00:00,2,10068,10044,24,24,318,11.0
2018-01-20 00:00:00,2,10452,10476,-24,41,28534,11.0
2018-01-20 01:00:00,2,10748,10584,164,25,1082,11.0
2018-01-20 02:00:00,2,2006,2376,-370,42,320,11.0
2018-01-20 03:00:00,2,10319,9828,491,36,200,13.5
2018-01-20 04:00:00,2,7052,7050,2,34,118,11.0
2018-01-20 05:00:00,2,9972,9936,36,17,3012,11.0
2018-01-20 06:00:00,1,680,486,194,26,256,11.0
2018-01-20 06:00:00,2,10088,10044,44,34,1324,11.0
2018-01-20 07:00:00,1,6944,6912,32,39,346,11.0
2018-01-20 07:00:00,2,7845,7776,69,21,1542,11.0
2018-01-20 08:00:00,1,8992,8910,82,34,476,11.0
2018-01-20 08:00:00,2,9605,9558,47,82,1180,11.0
2018-01-20 09:00:00,1,9608,9612,-4,67,922,11.0
2018-01-20 09:00:00,2,10300,10368,-68,103,654,11.0
2018-01-20 10:00:00,1,9348,9234,114,43,490,11.0
2018-01-20 10:00:00,2,9422,9288,134,81,422,11.0
2018-01-20 11:00:00,1,7512,7398,114,34,232,11.0
2018-01-20 11:00:00,2,10410,10368,42,61,598,11.0
2018-01-20 12:00:00,1,8806,8694,112,49,552,11.0
2018-01-20 12:00:00,2,9372,9234,138,79,1136,13.5
2018-01-20 13:00:00,1,8579,8532,47,38,256,11.0
2018-01-20 13:00:00,2,9412,9288,124,63,702,11.0
2018-01-20 14:00:00,1,7367,7848,-481,41,546,11.0
2018-01-20 14:00:00,2,10296,10368,-72,63,780,11.0
2018-01-20 15:00:00,2,10368,10260,108,22,594,11.0
2018-01-20 16:00:00,2,10556,10422,134,65,58114,11.0
2018-01-20 17:00:00,2,9900,9990,-90,16,226,11.0
2018-01-20 18:00:00,2,9476,9396,80,28,254,13.5
2018-01-20 19:00:00,2,10675,10530,145,29,218,11.0
2018-01-20 20:00:00,2,9768,9774,-6,40,374,11.0
2018-01-20 21:00:00,2,9430,9396,34,33,536,11.0
2018-01-20 22:00:00,2,10695,10638,57,22,196,11.0
2018-01-20 23:00:00,2,10416,10314,102,35,486,11.0
2018-01-21 00:00:00,2,3281,3294,-13,26,494,11.0
2018-01-21 01:00:00,2,9592,9504,88,21,176,11.0
2018-01-21 02:00:00,2,10455,10368,87,20,218,11.0
2018-01-21 03:00:00,2,9286,9180,106,20,2488,11.0
2018-01-21 04:00:00,2,9448,9396,52,27,526,11.0
2018-01-21 05:00:00,2,10152,10152,0,39,196,11.0
2018-01-21 06:00:00,1,1958,1296,662,40,618,11.0
2018-01-21 06:00:00,2,10480,10368,112,32,536,11.0
2018-01-21 07:00:00,1,4321,4320,1,38,296,11.0
2018-01-21 07:00:00,2,9224,9126,98,4,132,11.0
2018-01-21 08:00:00,1,8972,8910,62,37,360,13.5
2018-01-21 08:00:00,2,10092,10098,-6,54,2042,11.0
2018-01-21 09:00:00,1,8658,8586,72,67,476,11.0
2018-01-21 09:00:00,2,9396,9396,0,35,712,11.0
2018-01-21 10:00:00,1,9301,9234,67,50,364,11.0
2018-01-21 10:00:00,2,10132,9990,142,51,784,11.0
2018-01-21 11:00:00,1,8820,8748,72,57,522,11.0
2018-01-21 11:00:00,2,10488,10368,120,31,606,11.0
2018-01-21 12:00:00,1,7308,7236,72,34,274,13.5
2018-01-21 12:00:00,2,9784,9666,118,45,746,11.0
2018-01-21 13:00:00,1,8336,8262,74,25,224,11.0
2018-01-21 13:00:00,2,10298,10260,38,69,1406,11.0
2018-01-21 14:00:00,1,3058,3564,-506,32,438,11.0
2018-01-21 14:00:00,2,8759,8802,-43,42,698,11.0
2018-01-21 15:00:00,1,710,108,602,26,268,11.0
2018-01-21 15:00:00,2,8452,8262,190,21,5936,11.0
2018-01-21 16:00:00,1,7903,7884,19,57,788,11.0
2018-01-21 16:00:00,2,7392,7398,-6,3,26,11.0
2018-01-21 17:00:00,1,9696,9828,-132,36,814,11.0
2018-01-21 17:00:00,2,9185,9126,59,50,988,11.0
2018-01-21 18:00:00,1,10460,10206,254,70,1176,11.0
2018-01-21 18:00:00,2,1458,1908,-450,46,484,11.0
2018-01-21 19:00:00,1,8981,8910,71,68,612,11.0
2018-01-21 19:00:00,2,6432,5832,600,18,322,11.0
2018-01-21 20:00:00,1,9579,9558,21,32,3984,13.5
2018-01-21 20:00:00,2,10283,10260,23,43,570,11.0
2018-01-21 21:00:00,1,7802,7776,26,50,584,11.0
2018-01-21 21:00:00,2,9664,9612,52,39,504,11.0
2018-01-21 22:00:00,1,8940,8802,138,51,396,11.0
2018-01-21 22:00:00,2,8963,8856,107,106,1164,11.0
2018-01-21 23:00:00,1,9735,9720,15,26,510,11.0
2018-01-21 23:00:00,2,9052,9018,34,59,644,11.0
2018-01-22 00:00:00,1,9687,9666,21,46,552,13.5
2018-01-22 00:00:00,2,10600,10530,70,49,326,11.0
2018-01-22 01:00:00,1,10080,9936,144,22,656,11.0
2018-01-22 01:00:00,2,10860,10746,114,34,608,11.0
2018-01-22 02:00:00,1,9850,9774,76,28,196,11.0
2018-01-22 02:00:00,2,10848,10800,48,41,210,11.0
2018-01-22 03:00:00,1,10860,10854,6,24,98,11.0
2018-01-22 03:00:00,2,9832,9882,-50,50,396,11.0
2018-01-22 04:00:00,1,10387,10314,73,20,100,11.0
2018-01-22 04:00:00,2,10040,9990,50,21,70,11.0
2018-01-22 05:00:00,1,9472,9450,22,33,456,11.0
2018-01-22 05:00:00,2,10064,9936,128,38,358,11.0
2018-01-22 06:00:00,1,7541,7506,35,38,298,11.0
2018-01-22 06:00:00,2,8227,8154,73,62,402,11.0
2018-01-22 07:00:00,1,8884,8802,82,48,392,11.0
2018-01-22 07:00:00,2,8786,8802,-16,59,1146,11.0
2018-01-22 08:00:00,1,10339,10260,79,48,1266,13.5
2018-01-22 08:00:00,2,9580,9450,130,35,704,11.0
2018-01-22 09:00:00,1,6091,6048,43,32,360,12.5
2018-01-22 09:00:00,2,9702,9612,90,44,268,12.5
2018-01-22 10:00:00,1,8579,8640,-61,39,578,12.5
2018-01-22 10:00:00,2,9860,9828,32,33,1822,12.5
2018-01-22 11:00:00,1,9106,8964,142,42,408,12.5
2018-01-22 11:00:00,2,9324,9288,36,53,628,12.5
2018-01-22 12:00:00,1,3313,3294,19,41,458,16.5
2018-01-22 12:00:00,2,9576,9504,72,78,688,12.5
2018-01-22 13:00:00,1,8931,8856,75,36,530,12.5
2018-01-22 13:00:00,2,8844,8748,96,53,2470,12.5
2018-01-22 14:00:00,1,9140,9072,68,38,494,12.5
2018-01-22 14:00:00,2,9908,9990,-82,55,1144,12.5
2018-01-22 15:00:00,1,9892,9774,118,65,764,12.5
2018-01-22 15:00:00,2,7114,6966,148,24,178,12.5
2018-01-22 16:00:00,1,6486,7038,-552,31,562,12.5
2018-01-22 16:00:00,2,8822,8802,20,25,496,12.5
2018-01-22 17:00:00,1,106,0,106,28,1084,12.5
2018-01-22 17:00:00,2,8768,8748,20,29,5082,12.5
2018-01-22 18:00:00,1,9440,9072,368,61,764,12.5
2018-01-22 18:00:00,2,8831,8748,83,40,744,12.5
2018-01-22 19:00:00,1,10560,10368,192,40,416,12.5
2018-01-22 19:00:00,2,2582,3060,-478,25,776,12.5
2018-01-22 20:00:00,1,10412,10368,44,25,160,16.5
2018-01-22 21:00:00,1,9668,9666,2,22,9008,12.5
2018-01-22 21:00:00,2,1140,864,276,29,230,12.5
2018-01-22 22:00:00,1,6852,6804,48,43,480,12.5
2018-01-22 22:00:00,2,8696,8748,-52,12,438,12.5
2018-01-22 23:00:00,1,10580,10530,50,55,1346,12.5
2018-01-22 23:00:00,2,10779,10692,87,64,748,12.5
2018-01-23 00:00:00,1,1900,1890,10,50,158,12.5
2018-01-23 00:00:00,2,4012,3888,124,20,150,16.5
2018-01-23 01:00:00,1,5024,4860,164,6,3376,12.5
2018-01-23 01:00:00,2,6636,6696,-60,37,3298,12.5
2018-01-23 02:00:00,1,8816,8910,-94,52,1634,12.5
2018-01-23 02:00:00,2,9464,9342,122,39,494,12.5
2018-01-23 03:00:00,1,9524,9504,20,88,680,12.5
2018-01-23 03:00:00,2,8892,8910,-18,37,520,12.5
2018-01-23 04:00:00,1,10164,9990,174,89,460,12.5
2018-01-23 04:00:00,2,7812,7668,144,80,702,12.5
2018-01-23 05:00:00,1,9176,9180,-4,67,410,12.5
2018-01-23 05:00:00,2,7876,7884,-8,29,1266,12.5
2018-01-23 06:00:00,1,9180,9180,0,64,466,12.5
2018-01-23 06:00:00,2,10054,9936,118,84,864,12.5
2018-01-23 07:00:00,1,1100,1296,-196,163,586,12.5
2018-01-23 07:00:00,2,9437,9342,95,35,400,12.5
2018-01-23 08:00:00,2,8240,8262,-22,36,4450,12.5
2018-01-23 09:00:00,2,4556,4590,-34,33,490,16.5
2018-01-23 10:00:00,1,108,0,108,1,17102,12.5
2018-01-23 10:00:00,2,4942,4752,190,25,932,12.5
2018-01-23 11:00:00,2,1388,1404,-16,21,2640,12.5
2018-01-23 12:00:00,1,16,0,16,39,3124,12.5
2018-01-23 12:00:00,2,8943,8856,87,20,1676,12.5
2018-01-23 13:00:00,1,584,702,-118,46,640,12.5
2018-01-23 13:00:00,2,9461,9342,119,63,3450,12.5
2018-01-23 14:00:00,1,8,0,8,42,488,16.5
2018-01-23 14:00:00,2,10032,9990,42,3,15754,12.5
2018-01-23 15:00:00,1,32,0,32,34,410,12.5
2018-01-23 15:00:00,2,9892,9828,64,78,362,15.5
2018-01-23 16:00:00,1,12,0,12,29,948,15.5
2018-01-23 16:00:00,2,8952,8856,96,35,2014,15.5
2018-01-23 17:00:00,1,36,0,36,14,3914,15.5
2018-01-23 17:00:00,2,7992,7938,54,25,302,15.5
2018-01-23 18:00:00,1,248,216,32,27,1506,15.5
2018-01-23 18:00:00,2,6556,6534,22,49,606,15.5
2018-01-23 19:00:00,1,260,216,44,131,1292,15.5
2018-01-23 19:00:00,2,8979,8964,15,101,476,15.5
2018-01-23 20:00:00,1,6232,5994,238,122,840,15.5
2018-01-23 20:00:00,2,9684,9558,126,58,586,15.5
2018-01-23 21:00:00,1,8360,8424,-64,123,954,15.5
2018-01-23 21:00:00,2,9279,9234,45,33,368,15.5
2018-01-23 22:00:00,1,8090,8100,-10,58,830,19.0
2018-01-23 22:00:00,2,10043,10044,-1,33,576,15.5
2018-01-23 23:00:00,1,8695,8586,109,63,862,15.5
2018-01-23 23:00:00,2,9440,9342,98,24,302,15.5
2018-01-24 00:00:00,1,8051,7884,167,67,516,15.5
2018-01-24 00:00:00,2,10232,10152,80,20,474,15.5
2018-01-24 01:00:00,1,9432,9396,36,58,146,15.5
2018-01-24 01:00:00,2,9676,9612,64,38,816,15.5
2018-01-24 02:00:00,1,10516,10476,40,87,596,19.0
2018-01-24 02:00:00,2,8852,8748,104,31,3876,15.5
2018-01-24 03:00:00,1,9152,9072,80,54,348,15.5
2018-01-24 03:00:00,2,6646,7218,-572,22,840,15.5
2018-01-24 04:00:00,1,10046,9990,56,39,422,15.5
2018-01-24 04:00:00,2,715,270,445,40,710,15.5
2018-01-24 05:00:00,1,9668,9612,56,50,356,15.5
2018-01-24 05:00:00,2,8892,8694,198,23,166,15.5
2018-01-24 06:00:00,1,9928,9828,100,102,2416,15.5
2018-01-24 06:00:00,2,10580,10530,50,47,370,15.5
2018-01-24 07:00:00,1,9004,8964,40,30,764,15.5
2018-01-24 07:00:00,2,10180,10098,82,29,214,15.5
2018-01-24 08:00:00,1,3243,3132,111,42,434,15.5
2018-01-24 08:00:00,2,10336,10314,22,73,674,15.5
2018-01-24 09:00:00,1,9744,9666,78,108,708,15.5
2018-01-24 09:00:00,2,8964,8910,54,31,7770,15.5
2018-01-24 10:00:00,1,8756,8802,-46,83,686,19.0
2018-01-24 10:00:00,2,4759,4752,7,83,1374,15.5
2018-01-24 11:00:00,1,8948,8748,200,22,462,15.5
2018-01-24 11:00:00,2,80,0,80,78,3512,15.5
2018-01-24 12:00:00,1,6956,6912,44,32,3874,15.5
2018-01-24 12:00:00,2,3664,3402,262,43,252,15.5
2018-01-24 13:00:00,1,7669,8136,-467,51,306,15.5
2018-01-24 13:00:00,2,3063,3078,-15,68,524,15.5
2018-01-24 14:00:00,1,2471,1944,527,21,300,19.0
2018-01-24 14:00:00,2,6132,5994,138,82,822,15.5
2018-01-24 15:00:00,1,9341,9072,269,32,308,15.5
2018-01-24 15:00:00,2,10279,10152,127,56,284,15.5
2018-01-24 16:00:00,1,8356,8370,-14,54,660,15.5
2018-01-24 16:00:00,2,10147,9936,211,72,944,15.5
2018-01-24 17:00:00,1,10216,9990,226,29,230,15.5
2018-01-24 17:00:00,2,9083,9126,-43,2,4218,15.5
2018-01-24 18:00:00,1,8281,8640,-359,30,3074,15.5
2018-01-24 18:00:00,2,10367,10206,161,26,848,15.5
2018-01-24 19:00:00,1,0,18,-18,18,6034,15.5
2018-01-24 19:00:00,2,4834,4914,-80,55,392,15.5
2018-01-24 20:00:00,1,6142,5906,236,2,1334,15.5
2018-01-24 20:00:00,2,701,378,323,31,438,15.5
2018-01-24 21:00:00,1,9808,10302,-494,2,5962,15.5
2018-01-24 21:00:00,2,172,162,10,70,448,15.5
2018-01-24 22:00:00,1,9672,10082,-410,50,470,19.0
2018-01-24 22:00:00,2,184,108,76,47,1726,15.5
2018-01-24 23:00:00,1,9744,10176,-432,46,442,15.5
2018-01-24 23:00:00,2,112,108,4,41,518,15.5
2018-01-25 00:00:00,1,9754,10302,-548,56,338,15.5
2018-01-25 00:00:00,2,5255,5184,71,32,706,15.5
2018-01-25 01:00:00,1,9568,10046,-478,40,1690,15.5
2018-01-25 01:00:00,2,9568,9396,172,28,604,15.5
2018-01-25 02:00:00,1,10076,10576,-500,40,446,19.0
2018-01-25 02:00:00,2,8984,8856,128,18,310,15.5
2018-01-25 03:00:00,1,6867,7446,-579,45,468,15.5
2018-01-25 03:00:00,2,9724,9612,112,28,402,15.5
2018-01-25 04:00:00,1,8736,8963,-227,82,540,15.5
2018-01-25 04:00:00,2,9652,9612,40,63,706,15.5
2018-01-25 05:00:00,1,9648,9921,-273,72,1240,15.5
2018-01-25 05:00:00,2,9908,9774,134,35,1728,15.5
2018-01-25 06:00:00,1,9360,10022,-662,46,530,15.5
2018-01-25 06:00:00,2,9016,8964,52,48,704,15.5
2018-01-25 07:00:00,1,7199,7762,-563,54,708,15.5
2018-01-25 07:00:00,2,5648,5562,86,11,3780,15.5
2018-01-25 08:00:00,1,9317,9920,-603,94,402,15.5
2018-01-25 08:00:00,2,8940,8964,-24,47,682,15.5
2018-01-25 09:00:00,1,8794,9614,-820,79,450,15.5
2018-01-25 09:00:00,2,2800,2646,154,44,732,15.5
2018-01-25 10:00:00,1,9814,10516,-702,111,1000,19.5
2018-01-25 10:00:00,2,5732,5724,8,23,428,18.5
2018-01-25 11:00:00,1,9824,10382,-558,44,1060,18.5
2018-01-25 11:00:00,2,9040,8856,184,20,2508,18.5
2018-01-25 12:00:00,1,7892,8700,-808,78,1010,18.5
2018-01-25 12:00:00,2,9728,9666,62,44,1324,18.5
2018-01-25 13:00:00,1,8032,8646,-614,83,308,18.5
2018-01-25 13:00:00,2,3536,3510,26,29,3320,18.5
2018-01-25 14:00:00,1,7512,8274,-762,102,906,21.5
2018-01-25 14:00:00,2,6722,6696,26,25,492,18.5
2018-01-25 15:00:00,1,10124,10788,-664,91,682,18.5
2018-01-25 15:00:00,2,5078,5526,-448,35,440,18.5
2018-01-25 16:00:00,1,8939,9880,-941,40,410,18.5
2018-01-25 16:00:00,2,5422,4806,616,44,288,18.5
2018-01-25 17:00:00,1,8098,8856,-758,47,546,18.5
2018-01-25 17:00:00,2,9840,9666,174,25,1024,18.5
2018-01-25 18:00:00,1,9920,10518,-598,48,372,18.5
2018-01-25 18:00:00,2,9916,9882,34,48,524,18.5
2018-01-25 19:00:00,1,9292,9998,-706,49,506,18.5
2018-01-25 19:00:00,2,8100,7884,216,23,394,18.5
2018-01-25 20:00:00,1,9888,10394,-506,58,598,18.5
2018-01-25 20:00:00,2,9380,9288,92,51,1642,18.5
2018-01-25 21:00:00,1,9786,10344,-558,31,336,18.5
2018-01-25 21:00:00,2,9912,9774,138,91,872,18.5
2018-01-25 22:00:00,1,9051,9660,-609,37,906,21.5
2018-01-25 22:00:00,2,6020,5994,26,2,4304,18.5
2018-01-25 23:00:00,1,10066,10546,-480,41,640,18.5
2018-01-25 23:00:00,2,7874,8262,-388,31,1030,18.5
2018-01-26 00:00:00,1,8236,8718,-482,53,980,18.5
2018-01-26 00:00:00,2,0,36,-36,35,938,18.5
2018-01-26 01:00:00,1,9388,10022,-634,29,14748,18.5
2018-01-26 01:00:00,2,6058,5530,528,39,598,18.5
2018-01-26 02:00:00,1,7907,8538,-631,21,668,21.5
2018-01-26 02:00:00,2,8088,7912,176,36,550,18.5
2018-01-26 03:00:00,1,1708,1938,-230,48,884,18.5
2018-01-26 03:00:00,2,9212,9180,32,26,662,18.5
2018-01-26 04:00:00,2,9016,8911,105,32,730,18.5
2018-01-26 05:00:00,2,9360,9342,18,63,836,18.5
2018-01-26 06:00:00,2,8132,7993,139,57,852,18.5
2018-01-26 07:00:00,1,6416,6591,-175,100,954,18.5
2018-01-26 07:00:00,2,8711,8587,124,22,2680,18.5
2018-01-26 08:00:00,1,8416,8562,-146,53,716,18.5
2018-01-26 08:00:00,2,8872,8802,70,23,328,18.5
2018-01-26 09:00:00,1,8132,8162,-30,56,1118,18.5
2018-01-26 09:00:00,2,2964,3529,-565,23,142,18.5
2018-01-26 10:00:00,1,9032,9110,-78,50,532,18.5
2018-01-26 10:00:00,2,9278,8640,638,34,1038,18.5
2018-01-26 11:00:00,1,7368,7539,-171,55,722,18.5
2018-01-26 11:00:00,2,10656,10638,18,43,1882,21.5
2018-01-26 12:00:00,1,9391,9432,-41,103,448,20.5
2018-01-26 12:00:00,2,7920,7884,36,60,444,20.5
2018-01-26 13:00:00,1,8808,8914,-106,79,570,20.5
2018-01-26 13:00:00,2,5292,5238,54,46,510,20.5
2018-01-26 14:00:00,1,9604,9740,-136,28,222,20.5
2018-01-26 14:00:00,2,9848,9720,128,77,582,20.5
2018-01-26 15:00:00,1,9275,9395,-120,93,580,20.5
2018-01-26 15:00:00,2,9452,9504,-52,41,278,22.5
2018-01-26 16:00:00,1,10444,10479,-35,77,600,20.5
2018-01-26 16:00:00,2,9294,9180,114,39,420,20.5
2018-01-26 17:00:00,1,9332,9464,-132,18,534,23.5
2018-01-26 17:00:00,2,10275,10152,123,43,376,23.5
2018-01-26 18:00:00,1,9172,9199,-27,45,648,23.5
2018-01-26 18:00:00,2,9820,9720,100,83,408,23.5
2018-01-26 19:00:00,1,9547,9600,-53,49,460,23.5
2018-01-26 19:00:00,2,9940,9882,58,5,10,23.5
2018-01-26 20:00:00,1,8960,9095,-135,47,416,23.5
2018-01-26 20:00:00,2,9824,9666,158,42,694,23.5
2018-01-26 21:00:00,1,9628,9665,-37,54,844,23.5
2018-01-26 21:00:00,2,1992,1998,-6,53,1016,23.5
2018-01-26 22:00:00,1,9836,9980,-144,104,1734,23.5
2018-01-26 23:00:00,1,9344,9412,-68,64,1620,23.5
2018-01-27 00:00:00,1,8196,8335,-139,109,1322,23.5
2018-01-27 01:00:00,1,7788,7895,-107,80,776,26.0
2018-01-27 02:00:00,1,5609,5796,-187,53,626,23.5
2018-01-27 03:00:00,1,5980,6091,-111,31,412,23.5
2018-01-27 04:00:00,1,7291,7450,-159,27,330,23.5
2018-01-27 05:00:00,1,8075,8315,-240,51,540,23.5
2018-01-27 06:00:00,1,9196,9165,31,75,696,23.5
2018-01-27 07:00:00,1,9896,9960,-64,46,334,23.5
2018-01-27 07:00:00,2,3944,3972,-28,79,766,23.5
2018-01-27 08:00:00,1,9424,9494,-70,112,4180,23.0
2018-01-27 08:00:00,2,9120,8964,156,33,548,21.0
2018-01-27 09:00:00,1,9984,10125,-141,7,384,22.0
2018-01-27 09:00:00,2,8720,8640,80,38,476,22.0
2018-01-27 10:00:00,1,7572,7632,-60,59,1252,22.0
2018-01-27 10:00:00,2,9260,9180,80,81,798,22.0
2018-01-27 11:00:00,1,468,584,-116,41,716,22.0
2018-01-27 11:00:00,2,9760,9774,-14,44,734,22.0
2018-01-27 12:00:00,1,7415,7652,-237,34,29322,22.0
2018-01-27 12:00:00,2,8548,8424,124,36,58530,22.0
2018-01-27 13:00:00,1,8632,8589,43,3,78,22.0
2018-01-27 13:00:00,2,8819,8748,71,58,690,22.0
2018-01-27 14:00:00,1,6876,6707,169,66,976,22.0
2018-01-27 14:00:00,2,3222,3492,-270,39,584,22.0
2018-01-27 22:00:00,1,1824,1572,252,17,2776,22.0
2018-01-27 23:00:00,1,8908,8875,33,51,838,22.0
2018-01-28 00:00:00,1,8204,8233,-29,47,834,25.0
2018-01-28 01:00:00,1,9108,9138,-30,60,384,22.0
2018-01-28 02:00:00,1,2628,2979,-351,66,912,22.0
2018-01-28 03:00:00,1,7971,7668,303,1,2326,22.0
2018-01-28 04:00:00,1,8884,8802,82,46,372,22.0
2018-01-28 05:00:00,1,9563,9504,59,28,1558,22.0
2018-01-28 06:00:00,1,8349,8190,159,38,326,22.0
2018-01-28 07:00:00,1,9872,9882,-10,44,1360,22.0
2018-01-28 07:00:00,2,3334,2700,634,41,366,25.0
2018-01-28 08:00:00,1,10092,10044,48,34,892,22.0
2018-01-28 08:00:00,2,7064,7020,44,53,380,26.0
2018-01-28 09:00:00,1,10036,9990,46,40,940,26.0
2018-01-28 09:00:00,2,8716,8586,130,61,190,26.0
2018-01-28 10:00:00,1,9896,10044,-148,73,678,26.0
2018-01-28 10:00:00,2,7791,7776,15,53,348,26.0
2018-01-28 11:00:00,1,10388,10098,290,55,792,26.0
2018-01-28 11:00:00,2,8916,8856,60,65,836,26.0
2018-01-28 12:00:00,1,10072,9990,82,43,410,26.0
2018-01-28 12:00:00,2,8844,8802,42,64,498,26.0
2018-01-28 13:00:00,1,8936,9126,-190,54,750,26.0
2018-01-28 13:00:00,2,9784,9720,64,63,1328,26.0
2018-01-28 14:00:00,1,8928,8640,288,48,1464,26.0
2018-01-28 14:00:00,2,8752,8748,4,64,2838,26.0
2018-01-28 15:00:00,1,7226,7398,-172,53,440,26.0
2018-01-28 15:00:00,2,6840,7020,-180,68,488,29.5
2018-01-28 16:00:00,1,1807,1620,187,57,238,26.0
2018-01-28 16:00:00,2,9516,9234,282,60,602,26.0
2018-01-28 17:00:00,1,9560,9504,56,47,252,26.0
2018-01-28 17:00:00,2,10440,10368,72,61,704,26.0
2018-01-28 18:00:00,1,9180,9180,0,45,262,26.0
2018-01-28 18:00:00,2,10412,10368,44,53,490,26.0
2018-01-28 19:00:00,1,9068,8910,158,47,362,22.0
2018-01-28 19:00:00,2,10147,10044,103,108,406,25.0
2018-01-28 20:00:00,1,9460,9396,64,56,288,26.0
2018-01-28 20:00:00,2,10008,9990,18,43,488,26.0
2018-01-28 21:00:00,1,9771,9774,-3,48,346,26.0
2018-01-28 21:00:00,2,10128,10152,-24,54,302,26.0
2018-01-28 22:00:00,1,9668,9612,56,36,838,26.0
2018-01-28 22:00:00,2,10072,9990,82,65,822,26.0
2018-01-28 23:00:00,1,10099,10044,55,98,898,26.0
2018-01-28 23:00:00,2,8560,8424,136,55,1116,26.0
2018-01-29 00:00:00,1,8656,8586,70,67,1066,26.0
2018-01-29 00:00:00,2,8672,8694,-22,102,746,26.0
2018-01-29 01:00:00,1,7586,7506,80,97,562,26.0
2018-01-29 01:00:00,2,8452,8370,82,33,630,26.0
2018-01-29 02:00:00,1,8720,8694,26,93,902,26.0
2018-01-29 02:00:00,2,8607,8478,129,42,426,26.0
2018-01-29 03:00:00,1,9166,9126,40,48,744,26.0
2018-01-29 03:00:00,2,8360,8208,152,55,588,30.0
2018-01-29 04:00:00,1,9696,9666,30,48,1028,26.0
2018-01-29 04:00:00,2,8507,8370,137,47,1156,26.0
2018-01-29 05:00:00,1,9344,9234,110,67,514,26.0
2018-01-29 05:00:00,2,8221,8208,13,55,2704,26.0
2018-01-29 06:00:00,1,7412,7398,14,68,820,26.0
2018-01-29 06:00:00,2,9284,9180,104,56,910,26.0
2018-01-29 07:00:00,1,2699,2538,161,50,242,26.0
2018-01-29 07:00:00,2,8456,8316,140,36,1644,30.0
2018-01-29 08:00:00,1,8508,8478,30,43,572,28.5
2018-01-29 08:00:00,2,10380,10314,66,53,762,28.5
2018-01-29 09:00:00,1,5656,5670,-14,51,788,28.5
2018-01-29 09:00:00,2,10095,10098,-3,21,3778,28.5
2018-01-29 10:00:00,1,8720,8586,134,80,634,28.5
2018-01-29 10:00:00,2,7972,7920,52,22,464,28.5
2018-01-29 11:00:00,1,5076,5022,54,56,1234,28.5
2018-01-29 11:00:00,2,9148,9072,76,57,1680,28.5
2018-01-29 12:00:00,1,4576,4590,-14,86,970,28.5
2018-01-29 12:00:00,2,7203,7236,-33,55,612,28.5
2018-01-29 13:00:00,1,5648,5400,248,76,906,28.5
2018-01-29 13:00:00,2,7980,7938,42,6,3486,28.5
2018-01-29 14:00:00,1,9312,9288,24,2,3680,28.5
2018-01-29 14:00:00,2,7789,8244,-455,24,726,28.5
2018-01-29 15:00:00,1,610,684,-74,31,684,28.5
2018-01-29 15:00:00,2,474,0,474,60,1310,32.0
2018-01-29 16:00:00,1,8667,8478,189,34,278,28.5
2018-01-29 16:00:00,2,8556,8370,186,39,546,28.5
2018-01-29 17:00:00,1,7105,7074,31,44,552,28.5
2018-01-29 17:00:00,2,10228,10098,130,61,1180,28.5
2018-01-29 18:00:00,1,9739,9612,127,51,248,28.5
2018-01-29 18:00:00,2,9328,9234,94,48,1156,28.5
2018-01-29 19:00:00,1,7480,7398,82,42,310,28.5
2018-01-29 19:00:00,2,10400,10314,86,53,648,32.0
2018-01-29 20:00:00,1,6631,6480,151,56,438,28.5
2018-01-29 20:00:00,2,9992,9936,56,88,868,28.5
2018-01-29 21:00:00,1,9098,9018,80,51,378,28.5
2018-01-29 21:00:00,2,9704,9612,92,51,434,28.5
2018-01-29 22:00:00,1,8385,8316,69,15,3596,28.5
2018-01-29 22:00:00,2,9902,9774,128,83,1032,28.5
2018-01-29 23:00:00,1,9838,9774,64,78,696,28.5
2018-01-29 23:00:00,2,934,1494,-560,43,382,28.5
2018-01-30 00:00:00,1,7706,7668,38,29,8420,28.5
2018-01-30 00:00:00,2,7778,7020,758,60,480,28.5
2018-01-30 01:00:00,1,9939,9720,219,115,1066,28.5
2018-01-30 01:00:00,2,520,756,-236,78,720,28.5
2018-01-30 02:00:00,1,9795,9774,21,140,888,28.5
2018-01-30 03:00:00,1,7491,7398,93,83,578,28.5
2018-01-30 03:00:00,2,4531,4158,373,75,650,28.5
2018-01-30 04:00:00,1,8184,8046,138,75,1770,32.0
2018-01-30 04:00:00,2,9258,8856,402,120,31044,28.5
2018-01-30 05:00:00,1,9183,9126,57,121,1156,28.5
2018-01-30 05:00:00,2,5758,5508,250,81,354,28.5
2018-01-30 06:00:00,1,5502,5238,264,60,490,28.5
2018-01-30 06:00:00,2,7746,7614,132,51,710,28.5
2018-01-30 07:00:00,2,9804,9504,300,38,374,28.5
2018-01-30 08:00:00,2,9584,9558,26,61,676,28.5
2018-01-30 09:00:00,2,8924,8856,68,62,852,32.0
2018-01-30 10:00:00,2,9984,9936,48,20,70,28.5
2018-01-30 11:00:00,2,8924,8856,68,50,772,28.5
2018-01-30 12:00:00,2,8559,8370,189,90,932,28.5
2018-01-30 13:00:00,2,10936,10908,28,28,410,28.5
2018-01-30 14:00:00,2,8775,8694,81,84,928,28.5
2018-01-30 15:00:00,1,6807,6696,111,31,328,28.5
2018-01-30 15:00:00,2,9912,9828,84,30,2372,28.5
2018-01-30 16:00:00,1,8392,8316,76,34,442,28.5
2018-01-30 16:00:00,2,10204,10098,106,40,660,28.5
2018-01-30 17:00:00,1,3859,3726,133,60,508,28.5
2018-01-30 17:00:00,2,9744,9666,78,49,504,28.5
2018-01-30 18:00:00,1,8691,8478,213,28,1622,28.5
2018-01-30 18:00:00,2,9532,9396,136,44,820,28.5
2018-01-30 19:00:00,1,9535,9504,31,24,2028,28.5
2018-01-30 19:00:00,2,8440,8532,-92,76,942,28.5
2018-01-30 20:00:00,1,8680,8424,256,34,474,32.0
2018-01-30 20:00:00,2,2452,2160,292,51,688,28.5
2018-01-30 21:00:00,1,8252,8154,98,42,440,26.0
2018-01-30 21:00:00,2,9680,9612,68,69,1358,26.0
2018-01-30 22:00:00,1,8783,8694,89,48,1408,26.0
2018-01-30 22:00:00,2,9732,9666,66,55,1622,26.0
2018-01-30 23:00:00,1,6763,6588,175,40,520,26.0
2018-01-30 23:00:00,2,6832,6624,208,30,658,26.0
2018-01-31 00:00:00,1,5951,5886,65,62,1212,30.0
2018-01-31 00:00:00,2,9484,9450,34,41,744,26.0
2018-01-31 01:00:00,1,9260,9072,188,64,1006,26.0
2018-01-31 01:00:00,2,7800,7668,132,48,644,26.0
2018-01-31 02:00:00,1,8848,8730,118,29,3360,26.0
2018-01-31 02:00:00,2,8408,8316,92,59,630,26.0
2018-01-31 03:00:00,1,8871,8748,123,17,5396,26.0
2018-01-31 03:00:00,2,136,216,-80,32,826,26.0
2018-01-31 04:00:00,1,9084,8964,120,23,2156,26.0
2018-01-31 04:00:00,2,92,54,38,49,1252,26.0
2018-01-31 05:00:00,1,8604,8370,234,19,3130,26.0
2018-01-31 05:00:00,2,256,54,202,68,3188,26.0
2018-01-31 06:00:00,1,7114,7020,94,14,5776,26.0
2018-01-31 06:00:00,2,348,378,-30,8,138,26.0
2018-01-31 07:00:00,1,9119,9180,-61,16,840,26.0
2018-01-31 07:00:00,2,128,54,74,35,3472,26.0
2018-01-31 08:00:00,1,3004,2700,304,62,970,30.0
2018-01-31 08:00:00,2,996,702,294,15,240,26.0
2018-01-31 09:00:00,1,9147,9072,75,7,2982,26.0
2018-01-31 09:00:00,2,8156,7938,218,52,1196,26.0
2018-01-31 10:00:00,1,1684,1620,64,88,1362,26.0
2018-01-31 10:00:00,2,2391,2376,15,74,3350,26.0
2018-01-31 11:00:00,1,7476,7398,78,48,648,26.0
2018-01-31 11:00:00,2,6496,6264,232,41,372,26.0
2018-01-31 12:00:00,1,5505,5922,-417,63,1050,30.0
2018-01-31 12:00:00,2,9316,9180,136,81,1280,26.0
2018-01-31 13:00:00,1,4969,4482,487,39,714,26.0
2018-01-31 13:00:00,2,7555,7398,157,70,1904,25.0
2018-01-31 14:00:00,1,6980,6642,338,25,570,25.0
2018-01-31 14:00:00,2,9043,8856,187,56,768,25.0
2018-01-31 15:00:00,1,5216,5238,-22,42,674,25.0
2018-01-31 15:00:00,2,9220,9126,94,66,586,25.0
2018-01-31 16:00:00,1,8735,8640,95,54,538,25.0
2018-01-31 16:00:00,2,9292,9126,166,89,942,25.0
2018-01-31 17:00:00,1,9023,8838,185,53,412,25.0
2018-01-31 17:00:00,2,9344,9216,128,62,796,25.0
2018-01-31 18:00:00,1,8108,7992,116,60,676,25.0
2018-01-31 18:00:00,2,9864,9720,144,45,610,25.0
2018-01-31 19:00:00,1,8444,8460,-16,54,610,25.0
2018-01-31 19:00:00,2,9348,9234,114,55,720,25.0
2018-01-31 20:00:00,1,9247,9036,211,44,532,28.0
2018-01-31 20:00:00,2,8996,8856,140,77,2060,25.0
2018-01-31 21:00:00,1,8847,8748,99,57,500,25.0
2018-01-31 21:00:00,2,9559,9504,55,60,884,25.0
2018-01-31 22:00:00,1,5594,5346,248,64,802,25.0
2018-01-31 22:00:00,2,9524,9396,128,62,1512,25.0
2018-01-31 23:00:00,1,7272,7182,90,43,734,25.0
2018-01-31 23:00:00,2,8520,8532,-12,39,918,25.0
2018-02-01 00:00:00,1,6552,6426,126,13,2994,25.4
2018-02-01 00:00:00,2,8954,8856,98,31,1994,22.73333333333333
2018-02-01 01:00:00,1,8132,8046,86,42,714,22.73333333333333
2018-02-01 01:00:00,2,2010,1800,210,54,998,22.73333333333333
2018-02-01 02:00:00,1,5032,4860,172,45,932,22.73333333333333
2018-02-01 02:00:00,2,8588,8694,-106,36,342,22.73333333333333
2018-02-01 03:00:00,1,8008,7938,70,68,866,22.73333333333333
2018-02-01 03:00:00,2,8315,8316,-1,59,458,22.73333333333333
2018-02-01 04:00:00,1,9815,9720,95,48,774,22.73333333333333
2018-02-01 04:00:00,2,8356,8370,-14,90,3492,22.73333333333333
2018-02-01 05:00:00,1,9688,9504,184,50,600,22.73333333333333
2018-02-01 05:00:00,2,8672,8478,194,31,1190,22.73333333333333
2018-02-01 06:00:00,1,6671,6588,83,51,536,22.73333333333333
2018-02-01 06:00:00,2,9863,9720,143,48,2188,22.73333333333333
2018-02-01 07:00:00,1,1108,1080,28,84,814,22.73333333333333
2018-02-01 07:00:00,2,8984,8910,74,28,412,22.73333333333333
2018-02-01 08:00:00,1,4164,3996,168,27,586,25.4
2018-02-01 08:00:00,2,8632,8532,100,45,1720,22.73333333333333
2018-02-01 09:00:00,1,9584,9504,80,44,4806,22.73333333333333
2018-02-01 09:00:00,2,9228,9234,-6,44,530,22.73333333333333
2018-02-01 10:00:00,1,5968,5778,190,51,570,22.73333333333333
2018-02-01 10:00:00,2,7508,7668,-160,41,852,22.73333333333333
2018-02-01 11:00:00,1,9308,9126,182,81,1762,22.73333333333333
2018-02-01 11:00:00,2,92,54,38,55,714,22.73333333333333
2018-02-01 12:00:00,1,9308,9072,236,62,806,25.4
2018-02-01 12:00:00,2,8507,8208,299,48,938,22.73333333333333
2018-02-01 13:00:00,1,5545,5346,199,47,724,22.73333333333333
2018-02-01 13:00:00,2,8948,8964,-16,44,568,22.73333333333333
2018-02-01 14:00:00,1,8569,8424,145,103,1708,22.73333333333333
2018-02-01 14:00:00,2,8315,8154,161,42,560,22.73333333333333
2018-02-01 15:00:00,1,8812,8802,10,49,1260,22.73333333333333
2018-02-01 15:00:00,2,9615,9558,57,40,274,22.73333333333333
2018-02-01 16:00:00,1,5962,5832,130,39,928,22.73333333333333
2018-02-01 16:00:00,2,9064,9018,46,53,724,22.73333333333333
2018-02-01 17:00:00,1,7376,7020,356,54,3420,22.73333333333333
2018-02-01 17:00:00,2,10300,10314,-14,56,810,22.73333333333333
2018-02-01 18:00:00,1,7716,7560,156,19,406,22.73333333333333
2018-02-01 18:00:00,2,8876,8802,74,69,372,22.73333333333333
2018-02-01 19:00:00,1,7125,7074,51,37,404,24.066666666666663
2018-02-01 19:00:00,2,8876,8748,128,37,432,24.066666666666663
2018-02-01 20:00:00,1,3388,3240,148,36,1780,28.066666666666663
2018-02-01 20:00:00,2,9783,9666,117,25,30246,24.066666666666663
2018-02-01 21:00:00,1,9554,9396,158,45,1096,24.066666666666663
2018-02-01 21:00:00,2,10000,10206,-206,44,458,24.066666666666663
2018-02-01 22:00:00,1,7748,7776,-28,39,956,24.066666666666663
2018-02-01 22:00:00,2,2099,2052,47,39,650,24.066666666666663
2018-02-01 23:00:00,1,5420,5238,182,44,1118,24.066666666666663
2018-02-02 00:00:00,1,9834,9720,114,43,1326,24.066666666666663
2018-02-02 01:00:00,1,8392,8262,130,45,1864,28.066666666666663
2018-02-02 02:00:00,1,8912,8694,218,1,6142,27.066666666666663
2018-02-02 03:00:00,1,8240,8208,32,23,246,27.066666666666663
2018-02-02 04:00:00,1,6226,6048,178,1,3042,27.066666666666663
2018-02-02 05:00:00,1,6944,7326,-382,36,4126,27.066666666666663
2018-02-02 06:00:00,2,3943,3780,163,16,506,27.066666666666663
2018-02-02 07:00:00,1,156,0,156,17,508,27.066666666666663
2018-02-02 07:00:00,2,5756,5886,-130,106,11150,27.066666666666663
2018-02-02 08:00:00,1,1711,1242,469,37,400,27.066666666666663
2018-02-02 08:00:00,2,1814,1620,194,37,496,27.066666666666663
2018-02-02 09:00:00,1,6076,6102,-26,51,3052,27.566666666666663
2018-02-02 09:00:00,2,9811,9720,91,1,3288,27.566666666666663
2018-02-02 10:00:00,2,9644,9558,86,15,530,27.566666666666663
2018-02-02 11:00:00,2,8644,8802,-158,3,1692,27.566666666666663
2018-02-02 12:00:00,2,2474,2268,206,30,278,27.566666666666663
2018-02-02 13:00:00,1,576,432,144,34,602,27.566666666666663
2018-02-02 13:00:00,2,10316,10260,56,41,452,31.566666666666663
2018-02-02 14:00:00,1,8036,7884,152,56,1058,27.566666666666663
2018-02-02 14:00:00,2,9836,9828,8,38,834,27.566666666666663
2018-02-02 15:00:00,1,8024,8046,-22,21,4380,27.566666666666663
2018-02-02 15:00:00,2,8580,8370,210,30,4412,27.566666666666663
2018-02-02 16:00:00,1,7700,7560,140,2,122,27.566666666666663
2018-02-02 16:00:00,2,7316,7236,80,20,248,27.566666666666663
2018-02-02 17:00:00,1,664,864,-200,24,228,27.566666666666663
2018-02-02 17:00:00,2,815,918,-103,67,1586,31.566666666666663
2018-02-02 18:00:00,1,10252,9936,316,59,534,27.566666666666663
2018-02-02 18:00:00,2,6088,5994,94,61,360,30.566666666666663
2018-02-02 19:00:00,1,9572,9504,68,27,180,30.566666666666663
2018-02-02 19:00:00,2,9896,9774,122,60,568,30.566666666666663
2018-02-02 20:00:00,1,10428,10368,60,56,452,30.566666666666663
2018-02-02 20:00:00,2,9350,9504,-154,43,580,30.566666666666663
2018-02-02 21:00:00,1,9632,9558,74,47,454,30.566666666666663
2018-02-02 21:00:00,2,9379,9126,253,57,698,30.566666666666663
2018-02-02 22:00:00,1,9731,9774,-43,45,310,27.566666666666663
2018-02-02 22:00:00,2,9010,8910,100,63,628,27.566666666666663
2018-02-02 23:00:00,1,10216,9990,226,38,522,27.566666666666663
2018-02-02 23:00:00,2,9387,9342,45,58,414,27.566666666666663
2018-02-03 00:00:00,1,9547,9612,-65,54,284,27.566666666666663
2018-02-03 00:00:00,2,9608,9612,-4,50,216,27.566666666666663
2018-02-03 01:00:00,1,10224,10044,180,111,882,27.566666666666663
2018-02-03 01:00:00,2,10532,10422,110,74,788,31.566666666666663
2018-02-03 02:00:00,1,8207,8208,-1,92,576,27.566666666666663
2018-02-03 02:00:00,2,8972,9018,-46,63,202,27.566666666666663
2018-02-03 03:00:00,1,9243,9126,117,146,1112,27.566666666666663
2018-02-03 03:00:00,2,10212,9990,222,93,572,27.566666666666663
2018-02-03 04:00:00,1,7504,7506,-2,31,1538,27.566666666666663
2018-02-03 04:00:00,2,9320,9126,194,72,336,27.566666666666663
2018-02-03 05:00:00,1,6536,6480,56,36,690,27.566666666666663
2018-02-03 05:00:00,2,10135,9990,145,69,450,31.566666666666663
2018-02-03 06:00:00,1,8708,8640,68,47,490,27.566666666666663
2018-02-03 06:00:00,2,9659,9558,101,34,3010,27.566666666666663
2018-02-03 07:00:00,1,9720,9666,54,53,826,30.566666666666663
2018-02-03 07:00:00,2,2810,3330,-520,45,502,30.566666666666663
2018-02-03 08:00:00,1,8324,8208,116,39,360,30.566666666666663
2018-02-03 08:00:00,2,8162,7398,764,78,448,30.566666666666663
2018-02-03 09:00:00,1,10008,9990,18,53,1260,30.566666666666663
2018-02-03 09:00:00,2,9559,9396,163,44,2732,30.566666666666663
2018-02-03 10:00:00,1,7100,7074,26,57,452,30.566666666666663
2018-02-03 10:00:00,2,7436,7344,92,17,2500,30.566666666666663
2018-02-03 11:00:00,1,9724,9612,112,54,454,30.566666666666663
2018-02-03 11:00:00,2,2606,3078,-472,41,254,30.566666666666663
2018-02-03 12:00:00,1,9844,9774,70,111,720,30.566666666666663
2018-02-03 12:00:00,2,6350,5724,626,67,374,30.566666666666663
2018-02-03 13:00:00,1,8772,8694,78,57,352,30.566666666666663
2018-02-03 13:00:00,2,9875,9774,101,75,538,34.06666666666666
2018-02-03 14:00:00,1,10011,9936,75,52,580,30.566666666666663
2018-02-03 14:00:00,2,9408,9288,120,75,436,30.566666666666663
2018-02-03 15:00:00,1,9159,9180,-21,55,392,30.566666666666663
2018-02-03 15:00:00,2,9812,9936,-124,90,554,30.566666666666663
2018-02-03 16:00:00,1,9896,9774,122,39,396,30.566666666666663
2018-02-03 16:00:00,2,9500,9288,212,73,1288,30.566666666666663
2018-02-03 17:00:00,1,10056,9990,66,42,560,30.566666666666663
2018-02-03 17:00:00,2,6820,6750,70,74,626,34.06666666666666
2018-02-03 18:00:00,1,9168,9126,42,32,280,30.566666666666663
2018-02-03 18:00:00,2,9188,9126,62,79,348,30.566666666666663
2018-02-03 19:00:00,1,10628,10530,98,46,630,30.566666666666663
2018-02-03 19:00:00,2,10076,9936,140,83,1116,30.566666666666663
2018-02-03 20:00:00,1,8756,8694,62,43,910,30.566666666666663
2018-02-03 20:00:00,2,7649,7560,89,49,744,30.566666666666663
2018-02-03 21:00:00,1,8252,8262,-10,39,3826,30.566666666666663
2018-02-03 21:00:00,2,8676,8640,36,43,286,30.566666666666663
2018-02-03 22:00:00,1,4768,5256,-488,16,302,30.566666666666663
2018-02-03 22:00:00,2,10288,10152,136,58,430,30.566666666666663
2018-02-03 23:00:00,1,7516,3888,3628,38,120,30.566666666666663
2018-02-03 23:00:00,2,9832,9666,166,45,546,30.566666666666663
2018-02-04 00:00:00,1,10784,10638,146,33,524,30.566666666666663
2018-02-04 00:00:00,2,9476,9342,134,67,428,30.566666666666663
2018-02-04 01:00:00,1,9564,9558,6,22,566,30.566666666666663
2018-02-04 01:00:00,2,9931,9828,103,39,534,34.06666666666666
2018-02-04 02:00:00,1,9300,9072,228,44,460,30.566666666666663
2018-02-04 02:00:00,2,9268,9234,34,32,454,30.566666666666663
2018-02-04 03:00:00,1,9676,9558,118,19,76,30.566666666666663
2018-02-04 03:00:00,2,9748,9612,136,46,612,30.566666666666663
2018-02-04 04:00:00,1,10872,10854,18,17,1670,30.566666666666663
2018-02-04 04:00:00,2,9261,9072,189,48,1632,30.566666666666663
2018-02-04 05:00:00,1,6068,5922,146,27,330,30.566666666666663
2018-02-04 05:00:00,2,6094,5940,154,53,2086,34.06666666666666
2018-02-04 06:00:00,1,10064,9990,74,25,502,30.566666666666663
2018-02-04 06:00:00,2,6866,6750,116,38,1638,30.566666666666663
2018-02-04 07:00:00,1,9576,9504,72,35,458,30.566666666666663
2018-02-04 07:00:00,2,3765,3618,147,30,186,30.566666666666663
2018-02-04 08:00:00,1,9708,9666,42,55,2814,30.566666666666663
2018-02-04 08:00:00,2,10524,10422,102,36,354,30.566666666666663
2018-02-04 09:00:00,1,8268,8208,60,9,412,30.566666666666663
2018-02-04 09:00:00,2,10192,9990,202,49,496,30.566666666666663
2018-02-04 10:00:00,1,4044,3996,48,53,346,30.566666666666663
2018-02-04 10:00:00,2,9460,9450,10,31,236,30.566666666666663
2018-02-04 11:00:00,1,10012,9936,76,21,156,30.566666666666663
2018-02-04 11:00:00,2,10500,10368,132,44,380,30.566666666666663
2018-02-04 12:00:00,1,10680,10638,42,50,442,30.566666666666663
2018-02-04 12:00:00,2,9872,9936,-64,42,756,30.566666666666663
2018-02-04 13:00:00,1,9752,9666,86,49,608,30.566666666666663
2018-02-04 13:00:00,2,8884,8694,190,43,806,34.06666666666666
2018-02-04 14:00:00,1,9304,9180,124,35,452,30.566666666666663
2018-02-04 14:00:00,2,8620,8532,88,41,3358,30.566666666666663
2018-02-04 15:00:00,1,9818,9720,98,33,414,30.566666666666663
2018-02-04 15:00:00,2,5706,6210,-504,23,118,30.566666666666663
2018-02-04 16:00:00,1,9942,9882,60,19,418,30.566666666666663
2018-02-04 16:00:00,2,5834,5238,596,45,648,30.566666666666663
2018-02-04 17:00:00,1,9712,9720,-8,27,148,30.566666666666663
2018-02-04 17:00:00,2,9055,8964,91,51,624,34.06666666666666
2018-02-04 18:00:00,1,10696,10692,4,44,320,30.566666666666663
2018-02-04 18:00:00,2,9195,9126,69,43,1060,30.566666666666663
2018-02-04 19:00:00,1,10123,9990,133,18,332,30.566666666666663
2018-02-04 19:00:00,2,7900,7830,70,50,360,30.566666666666663
2018-02-04 20:00:00,1,10095,9936,159,24,468,30.566666666666663
2018-02-04 20:00:00,2,10028,10044,-16,58,384,30.566666666666663
2018-02-04 21:00:00,1,9712,9612,100,50,398,30.566666666666663
2018-02-04 21:00:00,2,9906,9720,186,53,146,30.566666666666663
2018-02-04 22:00:00,1,10052,9990,62,111,760,30.566666666666663
2018-02-04 22:00:00,2,10583,10530,53,66,334,30.566666666666663
2018-02-04 23:00:00,1,8563,8478,85,34,546,30.566666666666663
2018-02-04 23:00:00,2,10076,9990,86,56,684,30.566666666666663
2018-02-05 00:00:00,1,9312,9126,186,22,424,30.566666666666663
2018-02-05 00:00:00,2,9788,9774,14,71,288,30.566666666666663
2018-02-05 01:00:00,1,9852,9882,-30,22,252,30.566666666666663
2018-02-05 01:00:00,2,9388,9288,100,58,396,34.06666666666666
2018-02-05 02:00:00,1,10328,10206,122,23,522,30.566666666666663
2018-02-05 02:00:00,2,9916,9882,34,58,360,30.566666666666663
2018-02-05 03:00:00,1,9508,9396,112,62,302,30.566666666666663
2018-02-05 03:00:00,2,9936,9828,108,95,484,30.566666666666663
2018-02-05 04:00:00,1,10138,10044,94,34,394,30.566666666666663
2018-02-05 04:00:00,2,9588,9558,30,59,350,30.566666666666663
2018-02-05 05:00:00,1,9756,9774,-18,46,830,30.566666666666663
2018-02-05 05:00:00,2,9920,9828,92,55,284,34.06666666666666
2018-02-05 06:00:00,1,9124,8910,214,13,2274,30.566666666666663
2018-02-05 06:00:00,2,10172,10098,74,60,1184,30.566666666666663
2018-02-05 07:00:00,1,3600,3564,36,31,3796,30.566666666666663
2018-02-05 07:00:00,2,7580,7506,74,34,1844,30.566666666666663
2018-02-05 08:00:00,1,1302,1836,-534,30,3220,30.566666666666663
2018-02-05 08:00:00,2,5791,5724,67,43,640,30.566666666666663
2018-02-05 09:00:00,1,3178,2646,532,29,334,30.566666666666663
2018-02-05 09:00:00,2,8643,8532,111,41,792,30.566666666666663
2018-02-05 10:00:00,1,5806,5724,82,20,486,30.566666666666663
2018-02-05 10:00:00,2,8672,8532,140,41,250,30.566666666666663
2018-02-05 11:00:00,1,9788,9720,68,79,762,30.566666666666663
2018-02-05 11:00:00,2,10359,10260,99,48,946,30.566666666666663
2018-02-05 12:00:00,1,8359,8100,259,22,844,30.566666666666663
2018-02-05 12:00:00,2,8334,8424,-90,9,4410,30.566666666666663
2018-02-05 13:00:00,1,8412,8316,96,15,2048,30.566666666666663
2018-02-05 13:00:00,2,170,612,-442,18,1204,34.06666666666666
2018-02-05 14:00:00,1,6196,6102,94,10,2146,30.566666666666663
2018-02-05 14:00:00,2,6501,5832,669,33,684,30.566666666666663
2018-02-05 15:00:00,1,3512,3294,218,19,2312,30.566666666666663
2018-02-05 15:00:00,2,6940,6804,136,61,502,30.566666666666663
2018-02-05 16:00:00,1,3142,3222,-80,37,752,30.566666666666663
2018-02-05 16:00:00,2,9380,9342,38,63,622,30.566666666666663
2018-02-05 17:00:00,1,8888,8640,248,41,1198,30.566666666666663
2018-02-05 17:00:00,2,9132,8910,222,31,236,34.06666666666666
2018-02-05 18:00:00,1,7291,7074,217,128,904,30.566666666666663
2018-02-05 18:00:00,2,10252,10152,100,18,2766,30.566666666666663
2018-02-05 19:00:00,1,8259,8262,-3,89,1676,30.566666666666663
2018-02-05 19:00:00,2,2550,2430,120,53,236,30.566666666666663
2018-02-05 20:00:00,1,5804,5616,188,104,1006,30.566666666666663
2018-02-05 20:00:00,2,10436,10422,14,38,534,30.566666666666663
2018-02-05 21:00:00,1,7876,7776,100,40,376,30.566666666666663
2018-02-05 21:00:00,2,9435,9342,93,71,448,30.566666666666663
2018-02-05 22:00:00,1,9824,9720,104,90,812,30.566666666666663
2018-02-05 22:00:00,2,9680,9666,14,32,362,30.566666666666663
2018-02-05 23:00:00,1,8484,8316,168,61,444,30.566666666666663
2018-02-05 23:00:00,2,10234,10260,-26,64,384,30.566666666666663
2018-02-06 00:00:00,1,9624,9558,66,58,506,30.566666666666663
2018-02-06 00:00:00,2,9804,9666,138,62,776,30.566666666666663
2018-02-06 01:00:00,1,9640,9558,82,36,2176,30.566666666666663
2018-02-06 01:00:00,2,8844,8910,-66,64,1874,31.066666666666663
2018-02-06 02:00:00,1,4372,4266,106,68,1254,27.066666666666663
2018-02-06 02:00:00,2,8748,8748,0,22,786,27.066666666666663
2018-02-06 03:00:00,1,7420,7020,400,82,634,27.066666666666663
2018-02-06 03:00:00,2,5172,4914,258,75,376,27.066666666666663
2018-02-06 04:00:00,1,8740,8640,100,76,476,27.066666666666663
2018-02-06 04:00:00,2,9984,9882,102,102,608,27.066666666666663
2018-02-06 05:00:00,1,9560,9612,-52,33,720,27.066666666666663
2018-02-06 05:00:00,2,9342,9288,54,81,482,31.066666666666663
2018-02-06 06:00:00,1,9072,8802,270,45,876,27.066666666666663
2018-02-06 06:00:00,2,9412,9396,16,74,494,27.066666666666663
2018-02-06 07:00:00,1,7953,7992,-39,6,3686,27.066666666666663
2018-02-06 07:00:00,2,10532,10422,110,67,1026,27.066666666666663
2018-02-06 08:00:00,1,38,378,-340,30,984,27.066666666666663
2018-02-06 08:00:00,2,7028,7020,8,90,692,27.066666666666663
2018-02-06 09:00:00,1,7712,7128,584,24,904,27.066666666666663
2018-02-06 09:00:00,2,8908,8802,106,97,500,27.066666666666663
2018-02-06 10:00:00,1,8116,7938,178,36,790,27.066666666666663
2018-02-06 10:00:00,2,9500,9450,50,71,1194,27.066666666666663
2018-02-06 11:00:00,1,8507,8370,137,51,1702,27.066666666666663
2018-02-06 11:00:00,2,7376,7344,32,87,622,27.066666666666663
2018-02-06 12:00:00,1,5927,5868,59,21,4764,27.066666666666663
2018-02-06 12:00:00,2,9424,9504,-80,109,932,27.066666666666663
2018-02-06 13:00:00,1,1528,2052,-524,19,238,27.066666666666663
2018-02-06 13:00:00,2,8212,7992,220,58,864,31.066666666666663
2018-02-06 14:00:00,1,4965,4266,699,24,328,27.066666666666663
2018-02-06 14:00:00,2,8144,7938,206,66,598,27.066666666666663
2018-02-06 15:00:00,1,10052,9936,116,47,806,27.066666666666663
2018-02-06 15:00:00,2,9240,9180,60,65,260,27.066666666666663
2018-02-06 16:00:00,1,8456,8262,194,36,772,27.066666666666663
2018-02-06 16:00:00,2,10296,10206,90,41,700,27.066666666666663
2018-02-06 17:00:00,1,8700,8640,60,37,484,27.066666666666663
2018-02-06 17:00:00,2,9092,9126,-34,88,300,31.066666666666663
2018-02-06 18:00:00,1,9286,9072,214,90,660,27.066666666666663
2018-02-06 18:00:00,2,10096,9990,106,62,460,27.066666666666663
2018-02-06 19:00:00,1,9111,8964,147,31,3480,27.066666666666663
2018-02-06 19:00:00,2,9616,9504,112,68,314,27.066666666666663
2018-02-06 20:00:00,1,873,1422,-549,1,4058,27.066666666666663
2018-02-06 20:00:00,2,10098,10098,0,63,298,27.066666666666663
2018-02-06 21:00:00,1,390,0,390,50,484,27.066666666666663
2018-02-06 21:00:00,2,10296,10206,90,63,302,27.066666666666663
2018-02-06 22:00:00,1,6832,6588,244,40,4230,27.066666666666663
2018-02-06 22:00:00,2,10158,10044,114,64,332,27.066666666666663
2018-02-06 23:00:00,1,2440,2376,64,13,1562,27.066666666666663
2018-02-06 23:00:00,2,10100,10044,56,42,230,27.066666666666663
2018-02-07 00:00:00,1,2188,2160,28,48,1244,27.066666666666663
2018-02-07 00:00:00,2,9970,9990,-20,69,632,27.066666666666663
2018-02-07 01:00:00,1,6903,6750,153,40,304,27.066666666666663
2018-02-07 01:00:00,2,9224,9000,224,44,398,31.066666666666663
2018-02-07 02:00:00,1,10142,10098,44,47,278,30.066666666666663
2018-02-07 02:00:00,2,9912,9828,84,42,3148,30.066666666666663
2018-02-07 03:00:00,1,10256,10098,158,88,952,30.066666666666663
2018-02-07 03:00:00,2,7454,7956,-502,26,1316,30.066666666666663
2018-02-07 04:00:00,1,8108,8046,62,127,850,30.066666666666663
2018-02-07 04:00:00,2,402,0,402,39,1744,30.066666666666663
2018-02-07 05:00:00,1,8371,8262,109,106,1278,30.066666666666663
2018-02-07 05:00:00,2,5446,5076,370,45,1124,33.56666666666666
2018-02-07 06:00:00,1,7095,7074,21,73,1670,30.066666666666663
2018-02-07 06:00:00,2,7496,7344,152,49,4612,30.066666666666663
2018-02-07 07:00:00,1,5658,5454,204,58,576,30.066666666666663
2018-02-07 07:00:00,2,6035,6462,-427,7,62,30.066666666666663
2018-02-07 08:00:00,1,9351,9342,9,12,6512,30.066666666666663
2018-02-07 08:00:00,2,1630,1026,604,57,626,30.066666666666663
2018-02-07 09:00:00,1,1624,1602,22,68,336,30.066666666666663
2018-02-07 09:00:00,2,9095,9018,77,37,1860,30.066666666666663
2018-02-07 10:00:00,1,572,378,194,91,614,30.066666666666663
2018-02-07 10:00:00,2,9816,9666,150,81,1090,30.066666666666663
2018-02-07 11:00:00,1,5456,5400,56,129,376,30.066666666666663
2018-02-07 11:00:00,2,9158,9126,32,65,952,30.066666666666663
2018-02-07 12:00:00,1,7428,7344,84,122,404,30.066666666666663
2018-02-07 12:00:00,2,10051,9936,115,53,1048,30.066666666666663
2018-02-07 13:00:00,1,8420,8370,50,121,438,30.066666666666663
2018-02-07 13:00:00,2,9560,9450,110,87,2132,33.56666666666666
2018-02-07 14:00:00,1,7479,7398,81,73,1982,30.066666666666663
2018-02-07 14:00:00,2,9724,9612,112,39,596,30.066666666666663
2018-02-07 15:00:00,1,7176,7074,102,44,1192,30.066666666666663
2018-02-07 15:00:00,2,6392,6318,74,62,790,30.066666666666663
2018-02-07 16:00:00,1,6591,6426,165,55,806,30.066666666666663
2018-02-07 16:00:00,2,6000,5994,6,60,812,30.066666666666663
2018-02-07 17:00:00,1,8531,8424,107,21,2176,30.066666666666663
2018-02-07 17:00:00,2,8531,8316,215,56,740,33.56666666666666
2018-02-07 18:00:00,1,8471,8424,47,44,1218,30.066666666666663
2018-02-07 18:00:00,2,4844,4806,38,91,942,27.066666666666663
2018-02-07 19:00:00,1,8904,8748,156,7,5408,27.066666666666663
2018-02-07 19:00:00,2,6896,6750,146,68,906,27.066666666666663
2018-02-07 20:00:00,1,7997,7776,221,4,1234,27.066666666666663
2018-02-07 20:00:00,2,3387,3456,-69,72,830,27.066666666666663
2018-02-07 21:00:00,1,8260,8316,-56,51,462,27.066666666666663
2018-02-07 21:00:00,2,219,108,111,83,1528,27.566666666666663
2018-02-07 22:00:00,1,8901,8640,261,64,356,27.566666666666663
2018-02-07 22:00:00,2,7959,7776,183,53,688,27.566666666666663
2018-02-07 23:00:00,1,5778,5670,108,47,778,27.566666666666663
2018-02-07 23:00:00,2,9935,9882,53,73,1044,27.566666666666663
2018-02-08 00:00:00,1,8899,8856,43,99,568,27.566666666666663
2018-02-08 00:00:00,2,9233,9072,161,52,2006,27.566666666666663
2018-02-08 01:00:00,1,7781,7776,5,66,952,26.566666666666663
2018-02-08 01:00:00,2,8816,8640,176,102,1076,30.566666666666663
2018-02-08 02:00:00,1,4889,4698,191,82,286,26.566666666666663
2018-02-08 02:00:00,2,8150,7992,158,68,1652,26.566666666666663
2018-02-08 03:00:00,1,7593,7614,-21,36,2360,26.566666666666663
2018-02-08 03:00:00,2,10264,10206,58,40,826,26.566666666666663
2018-02-08 04:00:00,1,6360,6102,258,95,682,26.566666666666663
2018-02-08 04:00:00,2,3850,3834,16,40,824,26.566666666666663
2018-02-08 05:00:00,1,8232,8154,78,81,716,26.566666666666663
2018-02-08 05:00:00,2,8880,8964,-84,59,724,30.566666666666663
2018-02-08 06:00:00,1,8956,8892,64,89,668,26.566666666666663
2018-02-08 06:00:00,2,8936,8748,188,49,684,26.566666666666663
2018-02-08 07:00:00,1,8274,8208,66,106,548,26.566666666666663
2018-02-08 07:00:00,2,9011,8964,47,54,1592,26.566666666666663
2018-02-08 08:00:00,1,8976,8964,12,95,1372,26.566666666666663
2018-02-08 08:00:00,2,9256,9288,-32,54,1572,26.566666666666663
2018-02-08 09:00:00,1,6061,5994,67,76,992,26.566666666666663
2018-02-08 09:00:00,2,7654,7668,-14,28,1858,26.566666666666663
2018-02-08 10:00:00,1,6372,6372,0,60,1944,26.566666666666663
2018-02-08 10:00:00,2,7056,6858,198,56,1082,26.566666666666663
2018-02-08 11:00:00,1,5204,5130,74,84,764,26.566666666666663
2018-02-08 11:00:00,2,7448,7344,104,45,860,26.566666666666663
2018-02-08 12:00:00,1,7830,7776,54,112,970,26.566666666666663
2018-02-08 12:00:00,2,6439,6534,-95,40,1544,26.566666666666663
2018-02-08 13:00:00,1,8240,8208,32,43,2388,26.566666666666663
2018-02-08 13:00:00,2,7956,7884,72,35,2516,30.566666666666663
2018-02-08 14:00:00,1,6424,6318,106,102,584,26.566666666666663
2018-02-08 14:00:00,2,3720,3564,156,2,3110,26.566666666666663
2018-02-08 15:00:00,1,4764,5238,-474,104,840,26.566666666666663
2018-02-08 15:00:00,2,9358,9342,16,20,928,26.566666666666663
2018-02-08 16:00:00,1,593,0,593,47,1242,26.566666666666663
2018-02-08 16:00:00,2,8371,8316,55,25,406,26.566666666666663
2018-02-08 17:00:00,1,7928,7866,62,22,5446,26.566666666666663
2018-02-08 17:00:00,2,7287,7236,51,18,286,30.566666666666663
2018-02-08 18:00:00,1,9635,9612,23,9,166,26.566666666666663
2018-02-08 18:00:00,2,2010,2574,-564,34,234,26.566666666666663
2018-02-08 19:00:00,1,10338,10314,24,54,338,26.566666666666663
2018-02-08 19:00:00,2,2614,2106,508,67,1926,26.566666666666663
2018-02-08 20:00:00,1,10340,10260,80,64,304,26.566666666666663
2018-02-08 20:00:00,2,10056,9882,174,101,2310,26.566666666666663
2018-02-08 21:00:00,1,5396,5508,-112,65,4974,26.566666666666663
2018-02-08 21:00:00,2,10152,10098,54,19,224,26.566666666666663
2018-02-08 22:00:00,1,3251,2916,335,29,906,25.566666666666663
2018-02-08 22:00:00,2,1391,1512,-121,38,630,25.566666666666663
2018-02-08 23:00:00,1,10431,10260,171,52,370,25.566666666666663
2018-02-08 23:00:00,2,3297,3078,219,30,1020,25.566666666666663
2018-02-09 00:00:00,1,9344,9396,-52,62,774,25.566666666666663
2018-02-09 00:00:00,2,9232,9180,52,31,364,25.566666666666663
2018-02-09 01:00:00,1,7788,7506,282,47,550,25.566666666666663
2018-02-09 01:00:00,2,8605,8532,73,21,844,29.066666666666663
2018-02-09 02:00:00,1,10004,9882,122,50,216,25.566666666666663
2018-02-09 02:00:00,2,9432,9450,-18,12,218,25.566666666666663
2018-02-09 03:00:00,1,8524,8370,154,65,524,25.566666666666663
2018-02-09 03:00:00,2,10556,10476,80,63,10908,25.566666666666663
2018-02-09 04:00:00,1,10424,10422,2,45,1640,25.566666666666663
2018-02-09 04:00:00,2,9431,9288,143,1,9372,25.566666666666663
2018-02-09 05:00:00,1,6628,6642,-14,14,6738,25.566666666666663
2018-02-09 05:00:00,2,7112,7128,-16,4,7782,29.066666666666663
2018-02-09 06:00:00,2,0,54,-54,6,156,25.399999999999995
2018-02-09 08:00:00,1,3256,3348,-92,9,178,25.399999999999995
2018-02-09 08:00:00,2,196,162,34,37,592,25.399999999999995
2018-02-09 09:00:00,1,172,54,118,73,920,25.399999999999995
2018-02-09 10:00:00,1,1840,1836,4,37,422,25.399999999999995
2018-02-09 10:00:00,2,1048,1026,22,41,2398,25.399999999999995
2018-02-09 11:00:00,1,9320,9126,194,82,766,25.399999999999995
2018-02-09 11:00:00,2,8524,8478,46,52,1098,25.399999999999995
2018-02-09 12:00:00,1,9738,9720,18,56,552,29.399999999999995
2018-02-09 12:00:00,2,3668,3672,-4,54,1294,29.399999999999995
2018-02-09 13:00:00,1,8690,8586,104,53,960,29.399999999999995
2018-02-09 13:00:00,2,7335,7236,99,80,1574,29.399999999999995
2018-02-09 14:00:00,1,9227,9126,101,51,814,29.399999999999995
2018-02-09 14:00:00,2,7256,7182,74,62,536,29.399999999999995
2018-02-09 15:00:00,1,8156,8100,56,19,5188,29.399999999999995
2018-02-09 15:00:00,2,6192,6102,90,93,590,32.89999999999999
2018-02-09 16:00:00,1,8512,8478,34,16,358,29.39999999999999
2018-02-09 16:00:00,2,9464,9558,-94,97,930,29.39999999999999
2018-02-09 17:00:00,1,1532,2034,-502,76,888,29.39999999999999
2018-02-09 17:00:00,2,9132,8964,168,102,650,29.39999999999999
2018-02-09 18:00:00,1,3554,2916,638,73,582,29.39999999999999
2018-02-09 18:00:00,2,8576,8640,-64,132,756,29.39999999999999
2018-02-09 19:00:00,1,8575,8424,151,82,320,29.39999999999999
2018-02-09 19:00:00,2,8800,8640,160,92,574,32.89999999999999
2018-02-09 20:00:00,1,9120,9072,48,95,520,29.233333333333324
2018-02-09 20:00:00,2,8599,8586,13,106,520,29.233333333333324
2018-02-09 21:00:00,1,9772,9612,160,114,518,29.233333333333324
2018-02-09 21:00:00,2,9545,9504,41,96,476,29.233333333333324
2018-02-09 22:00:00,1,9284,9234,50,105,606,29.233333333333324
2018-02-09 22:00:00,2,9247,9126,121,97,818,29.233333333333324
2018-02-09 23:00:00,1,9380,9342,38,117,354,29.233333333333324
2018-02-09 23:00:00,2,9564,9558,6,103,644,29.233333333333324
2018-02-10 00:00:00,1,9011,8802,209,111,590,33.23333333333332
2018-02-10 00:00:00,2,8607,8532,75,101,722,33.23333333333332
2018-02-10 01:00:00,1,9836,9774,62,144,694,33.23333333333332
2018-02-10 01:00:00,2,8976,8910,66,92,546,33.23333333333332
2018-02-10 02:00:00,1,9043,8964,79,64,2562,33.23333333333332
2018-02-10 02:00:00,2,8768,8802,-34,111,692,29.23333333333332
2018-02-10 03:00:00,1,8764,8640,124,69,936,29.23333333333332
2018-02-10 03:00:00,2,9368,9234,134,102,1158,32.23333333333332
2018-02-10 04:00:00,1,4378,4914,-536,115,490,29.23333333333332
2018-02-10 04:00:00,2,8832,8802,30,12,3682,29.23333333333332
2018-02-10 05:00:00,1,6734,6300,434,126,440,29.23333333333332
2018-02-10 05:00:00,2,9004,9018,-14,43,1360,29.23333333333332
2018-02-10 06:00:00,1,9472,9234,238,120,1528,29.23333333333332
2018-02-10 06:00:00,2,196,612,-416,95,600,29.23333333333332
2018-02-10 07:00:00,1,9532,9450,82,91,712,29.23333333333332
2018-02-10 07:00:00,2,4616,4104,512,99,832,32.23333333333332
2018-02-10 08:00:00,1,7773,7722,51,113,778,29.23333333333332
2018-02-10 08:00:00,2,9276,9126,150,119,574,29.23333333333332
2018-02-10 09:00:00,1,7123,6966,157,112,492,29.23333333333332
2018-02-10 09:00:00,2,8496,8424,72,105,338,29.23333333333332
2018-02-10 10:00:00,1,8471,8424,47,90,1746,29.23333333333332
2018-02-10 10:00:00,2,9000,8910,90,84,582,29.23333333333332
2018-02-10 11:00:00,1,9451,9396,55,98,588,29.23333333333332
2018-02-10 11:00:00,2,9940,9828,112,110,994,29.23333333333332
2018-02-10 12:00:00,1,5468,5400,68,121,1266,29.23333333333332
2018-02-10 12:00:00,2,9248,9126,122,103,464,29.23333333333332
2018-02-10 13:00:00,1,9139,9072,67,78,1180,29.23333333333332
2018-02-10 13:00:00,2,8140,8154,-14,86,656,29.23333333333332
2018-02-10 14:00:00,1,7093,7020,73,100,748,29.23333333333332
2018-02-10 14:00:00,2,9520,9342,178,86,578,29.23333333333332
2018-02-10 15:00:00,1,7231,7074,157,108,1128,29.23333333333332
2018-02-10 15:00:00,2,8780,8748,32,134,622,32.23333333333332
2018-02-10 16:00:00,1,8603,8586,17,84,1176,29.23333333333332
2018-02-10 16:00:00,2,9382,9288,94,153,672,29.23333333333332
2018-02-10 17:00:00,1,7764,7722,42,109,968,29.23333333333332
2018-02-10 17:00:00,2,9068,9018,50,81,2852,29.23333333333332
2018-02-10 18:00:00,1,7150,7074,76,102,968,28.73333333333332
2018-02-10 18:00:00,2,8834,8694,140,81,372,28.73333333333332
2018-02-10 19:00:00,1,8472,8370,102,131,596,28.73333333333332
2018-02-10 19:00:00,2,5018,5562,-544,127,880,30.23333333333332
2018-02-10 20:00:00,1,7562,7344,218,128,886,26.23333333333332
2018-02-10 20:00:00,2,7064,6534,530,139,402,26.23333333333332
2018-02-10 21:00:00,1,8864,8748,116,137,390,26.23333333333332
2018-02-10 21:00:00,2,8148,7938,210,127,654,26.23333333333332
2018-02-10 22:00:00,1,8016,7938,78,164,658,26.23333333333332
2018-02-10 22:00:00,2,9768,9774,-6,122,494,26.23333333333332
2018-02-10 23:00:00,1,9620,9558,62,193,508,26.23333333333332
2018-02-10 23:00:00,2,9100,9018,82,80,398,26.23333333333332
2018-02-11 00:00:00,1,8695,8640,55,150,444,26.23333333333332
2018-02-11 00:00:00,2,9448,9396,52,124,434,26.23333333333332
2018-02-11 01:00:00,1,9404,9342,62,161,544,26.23333333333332
2018-02-11 01:00:00,2,9759,9612,147,61,460,26.23333333333332
2018-02-11 02:00:00,1,9224,9180,44,81,542,26.23333333333332
2018-02-11 02:00:00,2,9660,9612,48,51,438,26.23333333333332
2018-02-11 03:00:00,1,9235,9180,55,70,482,25.23333333333332
2018-02-11 03:00:00,2,9608,9558,50,51,392,27.23333333333332
2018-02-11 04:00:00,1,9414,9342,72,109,534,24.23333333333332
2018-02-11 04:00:00,2,9836,9720,116,57,320,24.23333333333332
2018-02-11 05:00:00,1,9368,9342,26,101,498,24.23333333333332
2018-02-11 05:00:00,2,9863,9828,35,59,600,24.23333333333332
2018-02-11 06:00:00,1,9292,9234,58,105,532,24.23333333333332
2018-02-11 06:00:00,2,10159,10044,115,61,538,24.23333333333332
2018-02-11 07:00:00,1,9399,9342,57,97,382,24.23333333333332
2018-02-11 07:00:00,2,9177,9126,51,66,628,26.23333333333332
2018-02-11 08:00:00,1,9316,9288,28,122,452,24.566666666666652
2018-02-11 08:00:00,2,9480,9342,138,81,996,24.566666666666652
2018-02-11 09:00:00,1,9692,9612,80,83,1070,24.566666666666652
2018-02-11 09:00:00,2,9339,9342,-3,89,536,24.566666666666652
2018-02-11 10:00:00,1,9536,9504,32,109,730,24.566666666666652
2018-02-11 10:00:00,2,7788,7614,174,70,520,24.566666666666652
2018-02-11 11:00:00,1,7756,7722,34,84,570,24.566666666666652
2018-02-11 11:00:00,2,9482,9396,86,79,740,24.566666666666652
2018-02-11 12:00:00,1,8600,8586,14,125,1056,24.566666666666652
2018-02-11 12:00:00,2,9700,9666,34,39,1964,24.566666666666652
2018-02-11 13:00:00,1,9152,9072,80,48,2520,24.566666666666652
2018-02-11 13:00:00,2,8576,8478,98,76,452,24.566666666666652
2018-02-11 14:00:00,1,7704,7722,-18,24,534,24.566666666666652
2018-02-11 14:00:00,2,5180,4788,392,59,452,24.566666666666652
2018-02-11 15:00:00,1,4562,5022,-460,57,642,24.566666666666652
2018-02-11 15:00:00,2,9764,9720,44,87,552,27.566666666666652
2018-02-11 16:00:00,1,8321,7668,653,79,1226,24.566666666666652
2018-02-11 16:00:00,2,9592,9504,88,70,644,26.566666666666652
2018-02-11 17:00:00,1,8947,8910,37,73,610,26.566666666666652
2018-02-11 17:00:00,2,9386,9342,44,58,3624,26.566666666666652
2018-02-11 18:00:00,1,7220,7398,-178,115,288,30.566666666666652
2018-02-11 18:00:00,2,9056,9072,-16,25,178,28.566666666666652
2018-02-11 19:00:00,1,9356,9234,122,135,672,28.566666666666652
2018-02-11 19:00:00,2,7686,8046,-360,57,550,32.06666666666665
2018-02-11 20:00:00,1,10000,9990,10,113,546,28.56666666666665
2018-02-11 20:00:00,2,2782,2214,568,67,402,28.56666666666665
2018-02-11 21:00:00,1,8841,8748,93,102,734,28.56666666666665
2018-02-11 21:00:00,2,9388,9342,46,144,816,28.56666666666665
2018-02-11 22:00:00,1,9219,9234,-15,100,1376,28.56666666666665
2018-02-11 22:00:00,2,9940,9828,112,86,512,28.56666666666665
2018-02-11 23:00:00,1,8688,8532,156,62,570,28.56666666666665
2018-02-11 23:00:00,2,8488,8424,64,64,684,28.56666666666665
2018-02-12 00:00:00,1,7609,7290,319,93,526,28.56666666666665
2018-02-12 00:00:00,2,9440,9450,-10,86,508,28.56666666666665
2018-02-12 01:00:00,1,8584,8532,52,113,824,28.56666666666665
2018-02-12 01:00:00,2,8928,8856,72,86,436,28.56666666666665
2018-02-12 02:00:00,1,8988,8964,24,77,458,28.56666666666665
2018-02-12 02:00:00,2,9616,9450,166,75,934,28.56666666666665
2018-02-12 03:00:00,1,8627,8640,-13,60,1174,28.56666666666665
2018-02-12 03:00:00,2,9744,9720,24,51,868,32.06666666666665
2018-02-12 04:00:00,1,9513,9342,171,70,5074,28.56666666666665
2018-02-12 04:00:00,2,8012,7938,74,117,594,28.56666666666665
2018-02-12 05:00:00,1,7608,7614,-6,67,346,28.56666666666665
2018-02-12 05:00:00,2,8460,8424,36,6,3108,28.56666666666665
2018-02-12 06:00:00,1,8600,8532,68,47,652,28.56666666666665
2018-02-12 06:00:00,2,9316,9126,190,44,6304,28.56666666666665
2018-02-12 07:00:00,1,20,0,20,1,7634,28.56666666666665
2018-02-12 07:00:00,2,9960,9882,78,1,13200,32.06666666666665
2018-02-12 08:00:00,1,244,270,-26,27,396,28.56666666666665
2018-02-12 08:00:00,2,9084,9072,12,46,244,28.56666666666665
2018-02-12 09:00:00,1,4724,4878,-154,51,436,28.56666666666665
2018-02-12 09:00:00,2,3532,3726,-194,5,220,28.56666666666665
2018-02-12 11:00:00,1,12,0,12,79,478,28.56666666666665
2018-02-12 11:00:00,2,8284,8046,238,67,748,28.56666666666665
2018-02-12 12:00:00,1,505,486,19,92,680,28.56666666666665
2018-02-12 12:00:00,2,10288,10260,28,67,764,28.56666666666665
2018-02-12 13:00:00,1,224,216,8,68,972,28.56666666666665
2018-02-12 13:00:00,2,9848,9720,128,72,1214,28.56666666666665
2018-02-12 14:00:00,1,2508,2322,186,46,310,28.56666666666665
2018-02-12 14:00:00,2,9764,9828,-64,71,334,28.56666666666665
2018-02-12 15:00:00,1,9040,8964,76,52,396,28.56666666666665
2018-02-12 15:00:00,2,8806,8586,220,88,758,28.56666666666665
2018-02-12 16:00:00,1,8340,8262,78,62,568,28.56666666666665
2018-02-12 16:00:00,2,8026,7992,34,77,584,32.06666666666665
2018-02-12 17:00:00,1,7365,7020,345,43,1046,28.56666666666665
2018-02-12 17:00:00,2,10154,10098,56,95,330,28.56666666666665
2018-02-12 18:00:00,1,9832,9774,58,80,752,28.56666666666665
2018-02-12 18:00:00,2,9984,10044,-60,116,588,28.56666666666665
2018-02-12 19:00:00,1,9036,9018,18,61,476,28.56666666666665
2018-02-12 19:00:00,2,9568,9396,172,112,1322,28.56666666666665
2018-02-12 20:00:00,1,8794,8748,46,47,1234,28.56666666666665
2018-02-12 20:00:00,2,7552,7452,100,45,2146,32.06666666666665
2018-02-12 21:00:00,1,10000,9936,64,93,586,28.56666666666665
2018-02-12 21:00:00,2,8808,8640,168,82,1222,28.56666666666665
2018-02-12 22:00:00,1,9072,9126,-54,48,716,28.56666666666665
2018-02-12 22:00:00,2,9600,9504,96,92,644,28.56666666666665
2018-02-12 23:00:00,1,6920,6804,116,66,576,28.56666666666665
2018-02-12 23:00:00,2,7216,7128,88,66,3022,28.56666666666665
2018-02-13 00:00:00,1,4340,4320,20,79,548,28.56666666666665
2018-02-13 00:00:00,2,9456,9342,114,38,712,28.56666666666665
2018-02-13 01:00:00,1,7152,7074,78,26,7830,28.56666666666665
2018-02-13 01:00:00,2,8736,8694,42,45,594,28.56666666666665
2018-02-13 02:00:00,1,8959,8910,49,60,1346,28.56666666666665
2018-02-13 02:00:00,2,9418,9342,76,2,3282,28.56666666666665
2018-02-13 03:00:00,1,6036,5994,42,80,506,28.56666666666665
2018-02-13 03:00:00,2,9466,9234,232,34,1134,28.56666666666665
2018-02-13 04:00:00,1,4859,4806,53,71,1138,28.56666666666665
2018-02-13 04:00:00,2,1722,2286,-564,58,668,32.06666666666665
2018-02-13 05:00:00,1,9054,9180,-126,6,3960,28.56666666666665
2018-02-13 06:00:00,1,6720,6480,240,44,220,28.56666666666665
2018-02-13 07:00:00,1,9476,9342,134,27,450,28.56666666666665
2018-02-13 07:00:00,2,4656,4050,606,58,714,28.56666666666665
2018-02-13 08:00:00,1,7924,7992,-68,44,650,28.56666666666665
2018-02-13 08:00:00,2,8800,8640,160,81,502,28.56666666666665
2018-02-13 09:00:00,1,178,666,-488,48,320,28.56666666666665
2018-02-13 09:00:00,2,10268,10206,62,50,272,32.06666666666665
2018-02-13 10:00:00,1,8185,7560,625,40,896,28.56666666666665
2018-02-13 10:00:00,2,8860,8694,166,61,690,28.56666666666665
2018-02-13 11:00:00,1,8616,8532,84,31,444,28.56666666666665
2018-02-13 11:00:00,2,9539,9450,89,34,3302,28.06666666666665
2018-02-13 12:00:00,1,10044,9990,54,52,532,28.06666666666665
2018-02-13 12:00:00,2,10144,9936,208,55,392,28.06666666666665
2018-02-13 13:00:00,1,8264,8262,2,36,456,28.06666666666665
2018-02-13 13:00:00,2,8884,8802,82,33,420,29.06666666666665
2018-02-13 14:00:00,1,9700,9666,34,51,1450,29.06666666666665
2018-02-13 14:00:00,2,2878,3420,-542,39,418,29.06666666666665
2018-02-13 15:00:00,1,9459,9288,171,32,958,29.06666666666665
2018-02-13 15:00:00,2,7598,6966,632,23,950,29.06666666666665
2018-02-13 16:00:00,1,9707,9666,41,53,852,29.06666666666665
2018-02-13 16:00:00,2,9892,9882,10,46,560,29.06666666666665
2018-02-13 17:00:00,1,6518,6534,-16,62,374,29.06666666666665
2018-02-13 17:00:00,2,9743,9594,149,36,404,34.06666666666665
2018-02-13 18:00:00,1,8042,7992,50,32,370,33.06666666666665
2018-02-13 18:00:00,2,8160,8100,60,30,410,33.06666666666665
2018-02-13 19:00:00,1,8479,8316,163,62,842,33.06666666666665
2018-02-13 19:00:00,2,9408,9288,120,26,1068,33.06666666666665
2018-02-13 20:00:00,1,9856,9882,-26,45,784,33.06666666666665
2018-02-13 20:00:00,2,9900,9720,180,28,368,33.06666666666665
2018-02-13 21:00:00,1,10019,9882,137,63,444,33.06666666666665
2018-02-13 21:00:00,2,9847,9720,127,37,496,37.56666666666665
2018-02-13 22:00:00,1,8501,8460,41,45,1142,33.06666666666665
2018-02-13 22:00:00,2,8624,8640,-16,86,840,31.56666666666665
2018-02-13 23:00:00,1,8520,8532,-12,33,346,31.56666666666665
2018-02-13 23:00:00,2,9076,8964,112,24,2920,31.56666666666665
2018-02-14 00:00:00,1,9914,9774,140,25,850,31.56666666666665
2018-02-14 00:00:00,2,9560,9450,110,68,920,31.56666666666665
2018-02-14 01:00:00,1,7552,7470,82,55,960,31.56666666666665
2018-02-14 01:00:00,2,8524,8478,46,48,912,32.06666666666665
2018-02-14 02:00:00,1,9884,9828,56,48,9966,32.06666666666665
2018-02-14 02:00:00,2,1927,1836,91,47,316,32.06666666666665
2018-02-14 03:00:00,1,8500,8424,76,13,31286,32.06666666666665
2018-02-14 03:00:00,2,8180,8154,26,23,226,32.06666666666665
2018-02-14 04:00:00,1,8022,7992,30,32,250,32.06666666666665
2018-02-14 04:00:00,2,8224,8154,70,42,866,32.06666666666665
2018-02-14 05:00:00,1,9400,9234,166,49,588,32.06666666666665
2018-02-14 05:00:00,2,10104,9936,168,61,700,35.56666666666665
2018-02-14 06:00:00,1,68,216,-148,59,764,31.89999999999998
2018-02-14 06:00:00,2,2944,3078,-134,54,840,31.89999999999998
2018-02-14 08:00:00,1,3579,3564,15,7,142,32.89999999999998
2018-02-14 09:00:00,1,10308,10152,156,42,464,32.89999999999998
2018-02-14 10:00:00,1,8491,8370,121,40,2350,32.89999999999998
2018-02-14 11:00:00,1,9272,9234,38,56,462,32.89999999999998
2018-02-14 12:00:00,1,9106,9126,-20,31,1474,32.89999999999998
2018-02-14 13:00:00,1,8451,8316,135,58,442,36.89999999999998
2018-02-14 14:00:00,1,9336,9288,48,30,2372,35.89999999999998
2018-02-14 14:00:00,2,60,162,-102,52,478,35.89999999999998
2018-02-14 15:00:00,1,8808,8748,60,58,536,35.89999999999998
2018-02-14 15:00:00,2,3612,3402,210,30,1160,35.89999999999998
2018-02-14 16:00:00,1,9690,9504,186,67,358,35.89999999999998
2018-02-14 16:00:00,2,6580,6534,46,42,226,35.89999999999998
2018-02-14 17:00:00,1,9816,9774,42,53,366,35.89999999999998
2018-02-14 17:00:00,2,4576,4482,94,34,9272,35.89999999999998
2018-02-14 18:00:00,1,9564,9558,6,29,1774,35.89999999999998
2018-02-14 18:00:00,2,9075,8748,327,67,428,35.89999999999998
2018-02-14 19:00:00,1,7508,7452,56,1,3290,35.89999999999998
2018-02-14 19:00:00,2,9972,9828,144,45,850,35.89999999999998
2018-02-14 20:00:00,1,10268,10152,116,2,154,35.89999999999998
2018-02-14 20:00:00,2,10144,10044,100,55,594,35.89999999999998
2018-02-14 21:00:00,1,2666,3168,-502,42,622,35.89999999999998
2018-02-14 21:00:00,2,5520,5454,66,94,1808,39.39999999999998
2018-02-14 22:00:00,2,9980,9882,98,71,622,35.89999999999998
2018-02-14 23:00:00,2,8452,8424,28,60,3428,36.89999999999998
2018-02-15 00:00:00,1,2489,1836,653,36,2974,36.89999999999998
2018-02-15 00:00:00,2,9256,9126,130,41,252,36.89999999999998
2018-02-15 01:00:00,1,9044,8964,80,44,848,36.89999999999998
2018-02-15 01:00:00,2,5472,5400,72,26,2016,36.89999999999998
2018-02-15 02:00:00,1,9147,8910,237,96,1166,36.89999999999998
2018-02-15 02:00:00,2,2878,3222,-344,64,2182,36.23333333333331
2018-02-15 03:00:00,1,3407,3402,5,61,1082,37.23333333333331
2018-02-15 03:00:00,2,7632,7020,612,90,962,37.23333333333331
2018-02-15 04:00:00,1,6848,6696,152,74,932,37.23333333333331
2018-02-15 04:00:00,2,5092,5184,-92,27,3170,37.23333333333331
2018-02-15 05:00:00,1,7372,7344,28,160,930,37.23333333333331
2018-02-15 05:00:00,2,5428,5346,82,68,578,36.23333333333331
2018-02-15 06:00:00,1,7996,7776,220,90,868,36.23333333333331
2018-02-15 06:00:00,2,7000,6804,196,82,612,36.23333333333331
2018-02-15 07:00:00,1,7807,7668,139,36,1836,36.23333333333331
2018-02-15 07:00:00,2,2380,2214,166,59,604,36.23333333333331
2018-02-15 08:00:00,1,8092,8100,-8,1,7076,36.23333333333331
2018-02-15 08:00:00,2,7936,7830,106,58,2092,36.23333333333331
2018-02-15 09:00:00,1,7991,7722,269,68,642,36.23333333333331
2018-02-15 09:00:00,2,9332,9234,98,71,356,36.23333333333331
2018-02-15 10:00:00,1,6444,6876,-432,72,326,36.23333333333331
2018-02-15 10:00:00,2,9159,9072,87,29,268,38.23333333333331
2018-02-15 11:00:00,2,4756,4698,58,74,374,39.23333333333331
2018-02-15 12:00:00,1,278,0,278,62,834,39.23333333333331
2018-02-15 12:00:00,2,8944,8856,88,61,216,39.23333333333331
2018-02-15 13:00:00,1,8899,8532,367,38,494,39.23333333333331
2018-02-15 13:00:00,2,10208,10152,56,84,404,39.23333333333331
2018-02-15 14:00:00,1,10448,10422,26,27,200,39.23333333333331
2018-02-15 14:00:00,2,9728,9612,116,69,380,39.23333333333331
2018-02-15 15:00:00,1,8280,8208,72,67,400,41.73333333333331
2018-02-15 15:00:00,2,10420,10314,106,68,386,39.23333333333331
2018-02-15 16:00:00,1,9564,9504,60,40,832,39.23333333333331
2018-02-15 16:00:00,2,9812,9774,38,87,252,39.23333333333331
2018-02-15 17:00:00,1,10644,10584,60,54,746,39.23333333333331
2018-02-15 17:00:00,2,9952,9828,124,42,276,39.23333333333331
2018-02-15 18:00:00,1,9728,9720,8,52,486,39.23333333333331
2018-02-15 18:00:00,2,10040,10044,-4,38,276,39.23333333333331
2018-02-15 19:00:00,1,8526,8478,48,49,456,39.23333333333331
2018-02-15 19:00:00,2,10107,9936,171,40,664,39.23333333333331
2018-02-15 20:00:00,1,8928,8856,72,24,304,39.23333333333331
2018-02-15 20:00:00,2,10368,10314,54,41,592,39.23333333333331
2018-02-15 21:00:00,1,9643,9504,139,53,236,39.23333333333331
2018-02-15 21:00:00,2,10108,10044,64,29,2590,39.23333333333331
2018-02-15 22:00:00,1,9516,9540,-24,42,486,39.23333333333331
2018-02-15 22:00:00,2,9587,9504,83,46,662,39.23333333333331
2018-02-15 23:00:00,1,10416,10314,102,37,316,41.73333333333331
2018-02-15 23:00:00,2,9004,8910,94,82,3870,39.23333333333331
2018-02-16 00:00:00,1,10172,10134,38,58,272,39.23333333333331
2018-02-16 00:00:00,2,3348,3348,0,15,138,39.23333333333331
2018-02-16 01:00:00,1,9926,9990,-64,42,344,39.23333333333331
2018-02-16 01:00:00,2,8576,8586,-10,88,458,39.23333333333331
2018-02-16 02:00:00,1,9952,9774,178,30,488,39.23333333333331
2018-02-16 02:00:00,2,6010,6462,-452,92,1548,39.23333333333331
2018-02-16 03:00:00,1,10028,9990,38,45,306,41.73333333333331
2018-02-16 03:00:00,2,3590,3186,404,107,450,39.23333333333331
2018-02-16 04:00:00,1,10035,9936,99,20,8906,39.23333333333331
2018-02-16 04:00:00,2,9701,9504,197,103,390,39.23333333333331
2018-02-16 05:00:00,1,9628,9558,70,85,986,39.23333333333331
2018-02-16 05:00:00,2,7088,7182,-94,5,226,39.23333333333331
2018-02-16 06:00:00,1,10184,10098,86,126,556,39.23333333333331
2018-02-16 06:00:00,2,8831,8586,245,73,1500,39.23333333333331
2018-02-16 07:00:00,1,5356,5400,-44,124,342,39.23333333333331
2018-02-16 07:00:00,2,9785,9720,65,38,1200,39.23333333333331
2018-02-16 08:00:00,2,7972,7938,34,142,362,39.23333333333331
2018-02-16 09:00:00,1,16,108,-92,67,502,39.23333333333331
2018-02-16 09:00:00,2,9348,9288,60,107,904,39.23333333333331
2018-02-16 10:00:00,1,6136,5886,250,38,680,39.23333333333331
2018-02-16 10:00:00,2,9952,9882,70,137,442,39.23333333333331
2018-02-16 11:00:00,1,7352,7236,116,49,528,39.23333333333331
2018-02-16 11:00:00,2,9856,9828,28,130,526,41.73333333333331
2018-02-16 12:00:00,1,9628,9612,16,57,662,39.23333333333331
2018-02-16 12:00:00,2,8336,8316,20,122,416,39.23333333333331
2018-02-16 13:00:00,1,8875,8694,181,51,418,39.23333333333331
2018-02-16 13:00:00,2,9571,9504,67,75,348,39.23333333333331
2018-02-16 14:00:00,1,9445,9342,103,43,740,39.23333333333331
2018-02-16 14:00:00,2,9376,9342,34,58,268,39.23333333333331
2018-02-16 15:00:00,1,9264,9180,84,25,344,39.23333333333331
2018-02-16 15:00:00,2,9648,9612,36,94,214,41.73333333333331
2018-02-16 16:00:00,1,9586,9504,82,48,412,39.23333333333331
2018-02-16 16:00:00,2,10136,10044,92,136,410,39.23333333333331
2018-02-16 17:00:00,1,8762,8964,-202,36,436,39.23333333333331
2018-02-16 17:00:00,2,10208,10206,2,114,572,39.23333333333331
2018-02-16 18:00:00,1,10088,9774,314,41,2398,39.23333333333331
2018-02-16 18:00:00,2,10448,10368,80,92,634,39.23333333333331
2018-02-16 19:00:00,1,9735,9774,-39,35,1960,39.23333333333331
2018-02-16 19:00:00,2,9784,9666,118,128,634,39.23333333333331
2018-02-16 20:00:00,1,9792,9666,126,28,2306,39.23333333333331
2018-02-16 20:00:00,2,9276,9234,42,161,532,39.23333333333331
2018-02-16 21:00:00,1,4065,4104,-39,66,560,39.23333333333331
2018-02-16 21:00:00,2,9104,9072,32,120,986,39.23333333333331
2018-02-16 22:00:00,1,6431,6372,59,47,634,39.23333333333331
2018-02-16 22:00:00,2,9076,9018,58,165,692,39.23333333333331
2018-02-16 23:00:00,1,2006,1890,116,78,322,39.23333333333331
2018-02-16 23:00:00,2,9471,9396,75,145,1806,41.73333333333331
2018-02-17 00:00:00,1,9260,9180,80,118,744,39.23333333333331
2018-02-17 00:00:00,2,7831,7776,55,158,732,39.23333333333331
2018-02-17 01:00:00,1,9143,9072,71,125,498,39.23333333333331
2018-02-17 01:00:00,2,8604,8640,-36,140,962,39.23333333333331
2018-02-17 02:00:00,1,9948,9990,-42,124,646,39.23333333333331
2018-02-17 02:00:00,2,6112,5994,118,179,852,39.23333333333331
2018-02-17 03:00:00,1,8830,8748,82,142,856,39.23333333333331
2018-02-17 03:00:00,2,8286,8262,24,116,2964,41.73333333333331
2018-02-17 04:00:00,1,9312,9180,132,84,1958,39.23333333333331
2018-02-17 04:00:00,2,7836,7776,60,43,208,39.23333333333331
2018-02-17 05:00:00,1,8912,8910,2,109,664,39.23333333333331
2018-02-17 05:00:00,2,8160,8100,60,106,2254,39.23333333333331
2018-02-17 06:00:00,1,8264,8262,2,25,2236,39.23333333333331
2018-02-17 06:00:00,2,8651,9180,-529,63,278,39.23333333333331
2018-02-17 07:00:00,1,5072,5076,-4,33,922,39.23333333333331
2018-02-17 07:00:00,2,3706,3078,628,79,2060,39.23333333333331
2018-02-17 08:00:00,1,8724,8586,138,58,720,39.23333333333331
2018-02-17 08:00:00,2,8663,8640,23,130,694,39.23333333333331
2018-02-17 09:00:00,1,5784,5886,-102,67,608,39.23333333333331
2018-02-17 09:00:00,2,5528,5454,74,130,732,39.23333333333331
2018-02-17 10:00:00,1,7996,7668,328,57,414,39.23333333333331
2018-02-17 10:00:00,2,4792,4806,-14,153,532,39.23333333333331
2018-02-17 11:00:00,1,7596,7614,-18,50,490,39.23333333333331
2018-02-17 11:00:00,2,8592,8586,6,124,1048,41.73333333333331
2018-02-17 12:00:00,1,9222,9018,204,67,512,39.23333333333331
2018-02-17 12:00:00,2,8852,8694,158,100,698,39.23333333333331
2018-02-17 13:00:00,1,9656,9666,-10,63,522,39.23333333333331
2018-02-17 13:00:00,2,9376,9342,34,113,820,39.23333333333331
2018-02-17 14:00:00,1,9600,9504,96,42,826,39.23333333333331
2018-02-17 14:00:00,2,7656,7560,96,138,706,39.23333333333331
2018-02-17 15:00:00,1,9524,9396,128,54,466,39.23333333333331
2018-02-17 15:00:00,2,8696,8856,-160,104,562,41.73333333333331
2018-02-17 16:00:00,1,9348,9378,-30,57,830,39.23333333333331
2018-02-17 16:00:00,2,8719,8532,187,81,974,39.23333333333331
2018-02-17 17:00:00,1,8656,8532,124,39,412,39.23333333333331
2018-02-17 17:00:00,2,8664,8532,132,128,450,39.23333333333331
2018-02-17 18:00:00,1,9572,9504,68,78,980,39.23333333333331
2018-02-17 18:00:00,2,9424,9396,28,102,860,39.23333333333331
2018-02-17 19:00:00,1,8588,8478,110,57,502,39.23333333333331
2018-02-17 19:00:00,2,7908,7830,78,70,798,39.083333333333314
2018-02-17 20:00:00,1,9588,9558,30,54,230,39.083333333333314
2018-02-17 20:00:00,2,9564,9504,60,112,738,39.083333333333314
2018-02-17 21:00:00,1,8440,8370,70,43,292,39.083333333333314
2018-02-17 21:00:00,2,8556,8748,-192,116,668,39.083333333333314
2018-02-17 22:00:00,1,9060,8964,96,55,480,39.083333333333314
2018-02-17 22:00:00,2,8312,8100,212,133,390,39.083333333333314
2018-02-17 23:00:00,1,10348,10260,88,53,240,39.083333333333314
2018-02-17 23:00:00,2,8816,8694,122,116,572,41.083333333333314
2018-02-18 00:00:00,1,10244,10152,92,39,956,39.083333333333314
2018-02-18 00:00:00,2,9244,9180,64,7,3402,39.083333333333314
2018-02-18 01:00:00,1,9656,9612,44,48,226,40.083333333333314
2018-02-18 01:00:00,2,9368,9288,80,126,1018,40.083333333333314
2018-02-18 02:00:00,1,10128,10098,30,55,868,40.083333333333314
2018-02-18 02:00:00,2,9248,9342,-94,144,870,40.083333333333314
2018-02-18 03:00:00,1,8200,8100,100,50,182,40.083333333333314
2018-02-18 03:00:00,2,516,396,120,148,652,43.083333333333314
2018-02-18 04:00:00,1,10416,10314,102,85,336,40.083333333333314
2018-02-18 04:00:00,2,7972,7776,196,122,778,40.083333333333314
2018-02-18 05:00:00,1,8523,8424,99,57,2258,40.083333333333314
2018-02-18 05:00:00,2,8659,8856,-197,132,630,40.083333333333314
2018-02-18 06:00:00,1,10368,10314,54,1,4860,40.083333333333314
2018-02-18 06:00:00,2,8464,8208,256,193,566,40.083333333333314
2018-02-18 07:00:00,1,9956,9882,74,16,436,40.083333333333314
2018-02-18 07:00:00,2,8652,8586,66,147,600,40.083333333333314
2018-02-18 08:00:00,1,5730,6210,-480,31,280,40.083333333333314
2018-02-18 08:00:00,2,9068,9126,-58,138,602,40.083333333333314
2018-02-18 09:00:00,2,9140,9018,122,51,212,40.083333333333314
2018-02-18 10:00:00,1,7828,3888,3940,120,422,40.083333333333314
2018-02-18 10:00:00,2,9268,9234,34,70,350,40.083333333333314
2018-02-18 11:00:00,1,9920,9774,146,119,680,40.083333333333314
2018-02-18 11:00:00,2,9308,9234,74,48,868,40.083333333333314
2018-02-18 12:00:00,1,10440,10260,180,147,664,43.083333333333314
2018-02-18 12:00:00,2,9439,9396,43,40,676,40.083333333333314
2018-02-18 13:00:00,1,9964,9882,82,106,802,40.083333333333314
2018-02-18 13:00:00,2,8903,8856,47,66,410,40.083333333333314
2018-02-18 14:00:00,1,8751,8910,-159,54,358,40.083333333333314
2018-02-18 14:00:00,2,9060,9018,42,56,668,40.083333333333314
2018-02-18 15:00:00,1,8628,8316,312,60,1118,40.083333333333314
2018-02-18 15:00:00,2,8364,8316,48,71,446,40.083333333333314
2018-02-18 16:00:00,1,9724,9666,58,83,632,43.083333333333314
2018-02-18 16:00:00,2,10056,9990,66,86,832,40.083333333333314
2018-02-18 17:00:00,1,8952,8910,42,112,648,40.083333333333314
2018-02-18 17:00:00,2,7680,7632,48,44,996,40.083333333333314
2018-02-18 18:00:00,1,9660,9504,156,124,848,40.083333333333314
2018-02-18 18:00:00,2,9236,9180,56,60,484,40.083333333333314
2018-02-18 19:00:00,1,9040,9072,-32,79,780,40.083333333333314
2018-02-18 19:00:00,2,9035,8964,71,54,542,40.083333333333314
2018-02-18 20:00:00,1,7830,7668,162,93,966,40.083333333333314
2018-02-18 20:00:00,2,8428,8370,58,53,380,40.083333333333314
2018-02-18 21:00:00,1,9028,9126,-98,95,1108,40.083333333333314
2018-02-18 21:00:00,2,8827,8802,25,71,296,40.083333333333314
2018-02-18 22:00:00,1,9467,9234,233,118,978,40.083333333333314
2018-02-18 22:00:00,2,8512,8478,34,67,472,40.083333333333314
2018-02-18 23:00:00,1,9932,9828,104,100,694,40.083333333333314
2018-02-18 23:00:00,2,7019,6966,53,69,266,40.083333333333314
2018-02-19 00:00:00,1,10088,10044,44,144,514,43.083333333333314
2018-02-19 00:00:00,2,8132,8100,32,65,266,40.083333333333314
2018-02-19 01:00:00,1,9596,9558,38,113,462,40.083333333333314
2018-02-19 01:00:00,2,8764,8694,70,69,744,40.083333333333314
2018-02-19 02:00:00,1,10112,10044,68,174,546,40.083333333333314
2018-02-19 02:00:00,2,9476,9396,80,90,478,40.083333333333314
2018-02-19 03:00:00,1,10224,10098,126,146,726,40.083333333333314
2018-02-19 03:00:00,2,9516,9504,12,67,232,40.083333333333314
2018-02-19 04:00:00,1,8672,8640,32,129,690,43.083333333333314
2018-02-19 04:00:00,2,9248,9180,68,81,322,40.083333333333314
2018-02-19 05:00:00,1,9600,9504,96,94,12774,40.083333333333314
2018-02-19 05:00:00,2,9232,9288,-56,80,380,40.083333333333314
2018-02-19 06:00:00,1,10219,10152,67,78,230,40.083333333333314
2018-02-19 06:00:00,2,8364,8208,156,40,538,40.083333333333314
2018-02-19 07:00:00,1,9976,9936,40,38,1116,40.083333333333314
2018-02-19 07:00:00,2,6328,6210,118,188,1664,40.083333333333314
2018-02-19 08:00:00,1,9827,9774,53,62,456,40.083333333333314
2018-02-19 08:00:00,2,0,54,-54,154,2040,40.083333333333314
2018-02-19 09:00:00,1,10332,10206,126,18,3230,40.083333333333314
2018-02-19 10:00:00,1,9280,9342,-62,37,3398,40.083333333333314
2018-02-19 10:00:00,2,348,288,60,23,224,40.083333333333314
2018-02-19 11:00:00,1,7760,7614,146,122,2492,40.083333333333314
2018-02-19 11:00:00,2,4804,4806,-2,45,5206,40.083333333333314
2018-02-19 12:00:00,1,9752,9720,32,2,4628,40.083333333333314
2018-02-19 12:00:00,2,4212,4212,0,9,122,43.083333333333314
2018-02-19 13:00:00,1,2251,2214,37,28,304,40.083333333333314
2018-02-19 13:00:00,2,872,810,62,60,554,40.083333333333314
2018-02-19 14:00:00,1,9044,9018,26,31,2740,40.083333333333314
2018-02-19 14:00:00,2,3232,3186,46,40,836,40.083333333333314
2018-02-19 15:00:00,1,3172,3672,-500,21,252,40.083333333333314
2018-02-19 15:00:00,2,5992,6048,-56,66,1298,40.083333333333314
2018-02-19 16:00:00,1,2506,2052,454,36,1182,40.083333333333314
2018-02-19 16:00:00,2,5672,5616,56,56,796,43.083333333333314
2018-02-19 17:00:00,1,9360,9126,234,52,794,40.083333333333314
2018-02-19 17:00:00,2,4359,4266,93,45,3334,40.083333333333314
2018-02-19 18:00:00,1,8396,8208,188,67,828,40.083333333333314
2018-02-19 18:00:00,2,8828,8748,80,6,1312,40.083333333333314
2018-02-19 19:00:00,1,8008,7992,16,62,1140,40.083333333333314
2018-02-19 19:00:00,2,7338,7236,102,46,2286,40.083333333333314
2018-02-19 20:00:00,1,7515,7560,-45,2,7032,40.083333333333314
2018-02-19 20:00:00,2,8788,8748,40,29,2306,37.083333333333314
2018-02-19 21:00:00,1,6353,6498,-145,7,124,3.0
2018-02-19 21:00:00,2,8644,8586,58,15,3152,3.0
2018-02-19 22:00:00,1,1334,756,578,40,260,3.0
2018-02-19 22:00:00,2,6946,7344,-398,12,3180,3.0
2018-02-19 23:00:00,1,4008,3780,228,40,230,3.0
2018-02-19 23:00:00,2,0,36,-36,26,1206,3.0
2018-02-20 00:00:00,1,3708,3780,-72,42,678,3.0
2018-02-20 00:00:00,2,514,108,406,43,1140,3.0
2018-02-20 01:00:00,1,1263,1152,111,10,3292,6.0
2018-02-20 01:00:00,2,10168,9936,232,40,3608,7.0
2018-02-20 02:00:00,1,2576,2376,200,51,568,7.0
2018-02-20 02:00:00,2,10368,10368,0,36,376,7.0
2018-02-20 03:00:00,1,5728,5508,220,61,350,7.0
2018-02-20 03:00:00,2,9131,8910,221,84,414,7.0
2018-02-20 04:00:00,1,7480,7074,406,33,472,7.0
2018-02-20 04:00:00,2,2010,1836,174,120,510,7.0
2018-02-20 05:00:00,1,3174,3582,-408,52,382,10.5
2018-02-20 05:00:00,2,8350,8208,142,71,664,7.0
2018-02-20 06:00:00,1,6330,5778,552,47,744,3.0
2018-02-20 06:00:00,2,9980,9882,98,69,1550,3.0
2018-02-20 07:00:00,1,9744,9612,132,53,1286,3.0
2018-02-20 07:00:00,2,9747,9612,135,63,296,3.0
2018-02-20 08:00:00,1,9544,9396,148,61,2260,3.0
2018-02-20 08:00:00,2,9880,9828,52,114,568,3.0
2018-02-20 09:00:00,1,8600,8532,68,92,562,3.0
2018-02-20 09:00:00,2,8884,8748,136,74,624,3.0
2018-02-20 10:00:00,1,6127,5994,133,28,230,3.0
2018-02-20 10:00:00,2,7144,7020,124,31,3314,3.0
2018-02-20 11:00:00,1,10212,10152,60,36,830,3.0
2018-02-20 11:00:00,2,6000,5940,60,20,1096,3.0
2018-02-20 12:00:00,1,9032,8964,68,41,1152,3.0
2018-02-20 12:00:00,2,7315,7236,79,36,2830,3.0
2018-02-20 13:00:00,1,8876,8802,74,45,1314,6.0
2018-02-20 13:00:00,2,10384,10476,-92,11,4274,3.0
2018-02-20 14:00:00,1,4374,4788,-414,10,4586,3.0
2018-02-20 14:00:00,2,8828,8802,26,17,1560,3.0
2018-02-20 15:00:00,1,4185,3618,567,28,424,3.0
2018-02-20 15:00:00,2,7392,7128,264,55,1920,3.0
2018-02-20 16:00:00,1,2691,2592,99,48,634,3.0
2018-02-20 16:00:00,2,7275,7398,-123,26,716,3.0
2018-02-20 17:00:00,1,0,306,-306,74,1200,6.0
2018-02-20 17:00:00,2,268,216,52,87,912,3.0
2018-02-20 18:00:00,1,3054,2430,624,29,2220,3.0
2018-02-20 18:00:00,2,6255,5994,261,22,5214,3.0
2018-02-20 19:00:00,1,7573,7398,175,57,1000,3.0
2018-02-20 19:00:00,2,9212,9126,86,21,266,3.0
2018-02-20 20:00:00,1,6028,5994,34,49,710,3.0
2018-02-20 20:00:00,2,7468,7398,70,44,550,3.0
2018-02-20 21:00:00,1,8167,7884,283,66,510,3.0
2018-02-20 21:00:00,2,5232,5346,-114,62,632,3.0
2018-02-20 22:00:00,1,1655,2196,-541,42,470,3.0
2018-02-20 22:00:00,2,6957,6804,153,67,346,3.0
2018-02-20 23:00:00,1,3326,2754,572,81,746,3.0
2018-02-20 23:00:00,2,8951,8856,95,57,424,3.0
2018-02-21 00:00:00,1,9348,9126,222,134,1424,3.0
2018-02-21 00:00:00,2,9604,9558,46,61,678,3.0
2018-02-21 01:00:00,1,8976,8964,12,16,2830,6.0
2018-02-21 01:00:00,2,9924,9882,42,56,442,3.0
2018-02-21 02:00:00,1,10076,9936,140,30,2146,3.0
2018-02-21 02:00:00,2,8484,8586,-102,95,668,3.0
2018-02-21 03:00:00,1,9566,9396,170,36,28978,3.0
2018-02-21 03:00:00,2,6860,6588,272,59,2616,3.0
2018-02-21 04:00:00,1,8843,8856,-13,96,760,3.0
2018-02-21 04:00:00,2,2332,2376,-44,163,730,2.0
2018-02-21 05:00:00,1,9740,9504,236,114,498,4.0
2018-02-21 05:00:00,2,4824,4752,72,68,990,2.0
2018-02-21 06:00:00,1,8911,8802,109,71,386,2.0
2018-02-21 06:00:00,2,6064,5922,142,86,484,2.0
2018-02-21 07:00:00,1,2848,2934,-86,89,534,2.0
2018-02-21 08:00:00,1,9080,8802,278,2,1632,2.0
2018-02-21 09:00:00,1,8196,8154,42,86,1016,2.0
2018-02-21 10:00:00,1,9332,9180,152,23,800,2.0
2018-02-21 11:00:00,1,7872,7830,42,2,4122,2.0
2018-02-21 12:00:00,1,9792,9666,126,58,964,2.0
2018-02-21 13:00:00,1,9512,9396,116,106,586,2.0
2018-02-21 14:00:00,1,9224,9288,-64,35,3906,2.0
2018-02-21 14:00:00,2,164,54,110,111,622,2.0
2018-02-21 15:00:00,1,7554,7884,-330,23,1548,2.0
2018-02-21 15:00:00,2,8224,8100,124,126,386,2.0
2018-02-21 16:00:00,1,42,0,42,34,2958,2.0
2018-02-21 16:00:00,2,8336,8316,20,116,414,4.5
2018-02-21 17:00:00,1,7656,7074,582,32,376,2.5
2018-02-21 17:00:00,2,2515,2952,-437,140,596,2.5
2018-02-21 18:00:00,1,9132,9072,60,56,386,2.5
2018-02-21 18:00:00,2,2958,2376,582,130,702,2.5
2018-02-21 19:00:00,1,9576,9578,-2,75,334,2.5
2018-02-21 19:00:00,2,4587,4644,-57,120,388,2.5
2018-02-21 20:00:00,1,9608,9504,104,39,554,2.5
2018-02-21 20:00:00,2,6736,6534,202,192,576,5.0
2018-02-21 21:00:00,1,8952,8910,42,90,598,2.5
2018-02-21 21:00:00,2,9956,9774,182,183,612,2.5
2018-02-21 22:00:00,1,8788,8748,40,36,336,2.5
2018-02-21 22:00:00,2,10040,9882,158,198,540,2.5
2018-02-21 23:00:00,1,9683,9558,125,29,282,2.5
2018-02-21 23:00:00,2,9396,9288,108,211,840,2.5
2018-02-22 00:00:00,1,8964,8910,54,62,458,2.5
2018-02-22 00:00:00,2,9444,9450,-6,198,742,2.5
2018-02-22 01:00:00,1,8908,8856,52,52,312,2.5
2018-02-22 01:00:00,2,10080,9936,144,184,674,2.5
2018-02-22 02:00:00,1,8888,8910,-22,45,544,2.5
2018-02-22 02:00:00,2,10192,10044,148,192,758,2.5
2018-02-22 03:00:00,1,8222,8154,68,48,426,2.5
2018-02-22 03:00:00,2,9624,9666,-42,108,386,2.5
2018-02-22 04:00:00,1,8232,8046,186,62,1388,2.5
2018-02-22 04:00:00,2,10176,10098,78,147,586,5.0
2018-02-22 05:00:00,1,8612,8640,-28,16,1778,3.6666666666666665
2018-02-22 05:00:00,2,10420,10422,-2,107,1342,3.6666666666666665
2018-02-22 06:00:00,1,8294,8208,86,37,1452,3.6666666666666665
2018-02-22 06:00:00,2,8828,8694,134,40,1828,3.6666666666666665
2018-02-22 07:00:00,1,9812,9774,38,60,500,3.6666666666666665
2018-02-22 07:00:00,2,6840,6858,-18,89,486,3.6666666666666665
2018-02-22 08:00:00,1,8980,8910,70,89,1038,3.6666666666666665
2018-02-22 08:00:00,2,6316,6156,160,140,730,5.666666666666666
2018-02-22 09:00:00,1,8068,8046,22,52,998,3.666666666666666
2018-02-22 09:00:00,2,6140,6048,92,156,1050,3.666666666666666
2018-02-22 10:00:00,1,3988,3996,-8,32,192,3.666666666666666
2018-02-22 10:00:00,2,9646,9774,-128,173,606,3.666666666666666
2018-02-22 11:00:00,1,9592,9504,88,46,426,3.666666666666666
2018-02-22 11:00:00,2,8536,8532,4,139,864,3.666666666666666
2018-02-22 12:00:00,1,8876,8856,20,30,482,3.666666666666666
2018-02-22 12:00:00,2,7180,7020,160,165,540,3.666666666666666
2018-02-22 13:00:00,1,7108,7074,34,43,346,5.666666666666666
2018-02-22 13:00:00,2,10724,10584,140,152,846,5.666666666666666
2018-02-22 14:00:00,1,8968,8910,58,21,1064,5.666666666666666
2018-02-22 14:00:00,2,9712,9558,154,142,418,5.666666666666666
2018-02-22 15:00:00,1,8119,8046,73,36,488,5.666666666666666
2018-02-22 15:00:00,2,9672,9666,6,141,918,5.666666666666666
2018-02-22 16:00:00,1,9148,9126,22,34,230,5.666666666666666
2018-02-22 16:00:00,2,10120,10044,76,165,830,8.666666666666666
2018-02-22 17:00:00,1,8420,8316,104,22,1158,8.133333333333333
2018-02-22 17:00:00,2,8248,8262,-14,172,888,8.133333333333333
2018-02-22 18:00:00,1,9400,9396,4,35,494,8.133333333333333
2018-02-22 18:00:00,2,9564,9450,114,151,992,8.133333333333333
2018-02-22 19:00:00,1,7976,7938,38,39,134,8.133333333333333
2018-02-22 19:00:00,2,10060,10044,16,122,1472,8.133333333333333
2018-02-22 20:00:00,1,8224,8154,70,22,1120,8.133333333333333
2018-02-22 20:00:00,2,8388,8424,-36,149,768,10.133333333333333
2018-02-22 21:00:00,1,8056,8100,-44,35,674,8.133333333333333
2018-02-22 21:00:00,2,9040,8910,130,179,610,8.133333333333333
2018-02-22 22:00:00,1,7863,7722,141,31,846,8.133333333333333
2018-02-22 22:00:00,2,10628,10476,152,173,628,8.133333333333333
2018-02-22 23:00:00,1,6460,6426,34,38,1616,8.133333333333333
2018-02-22 23:00:00,2,7852,7830,22,118,5262,8.133333333333333
2018-02-23 00:00:00,1,8232,8154,78,19,1188,8.133333333333333
2018-02-23 00:00:00,2,9052,8964,88,11,1610,9.466666666666667
2018-02-23 01:00:00,1,8818,8802,16,48,346,9.466666666666667
2018-02-23 01:00:00,2,8944,8964,-20,41,1254,9.466666666666667
2018-02-23 02:00:00,1,8860,8802,58,47,3396,9.466666666666667
2018-02-23 02:00:00,2,5684,5598,86,63,3850,9.466666666666667
2018-02-23 03:00:00,1,4326,4860,-534,31,238,9.466666666666667
2018-02-23 03:00:00,2,7420,7398,22,56,1258,9.466666666666667
2018-02-23 04:00:00,1,1014,432,582,29,774,9.466666666666667
2018-02-23 04:00:00,2,10168,10044,124,5,4598,13.466666666666667
2018-02-23 05:00:00,1,2232,2268,-36,38,808,13.466666666666667
2018-02-23 05:00:00,2,2786,3348,-562,86,5262,13.466666666666667
2018-02-23 06:00:00,1,4572,4266,306,27,938,13.466666666666667
2018-02-23 06:00:00,2,8374,7776,598,23,3012,13.466666666666667
2018-02-23 07:00:00,1,1772,1782,-10,32,1818,13.466666666666667
2018-02-23 07:00:00,2,8712,8640,72,26,184,13.466666666666667
2018-02-23 08:00:00,1,158,576,-418,43,2870,13.466666666666667
2018-02-23 08:00:00,2,9718,9774,-56,33,388,17.46666666666667
2018-02-23 09:00:00,1,5226,4644,582,57,3350,13.466666666666669
2018-02-23 09:00:00,2,7514,7344,170,86,420,13.466666666666669
2018-02-23 10:00:00,2,6966,6966,0,80,734,13.466666666666669
2018-02-23 11:00:00,1,2616,2538,78,57,658,13.466666666666669
2018-02-23 11:00:00,2,5084,5130,-46,158,768,13.466666666666669
2018-02-23 12:00:00,1,2036,1998,38,42,258,13.466666666666669
2018-02-23 12:00:00,2,9914,9828,86,177,652,13.466666666666669
2018-02-23 13:00:00,1,2812,2808,4,34,398,13.466666666666669
2018-02-23 13:00:00,2,9806,9720,86,147,734,13.466666666666669
2018-02-23 14:00:00,1,6468,6372,96,35,428,13.466666666666669
2018-02-23 14:00:00,2,8968,8856,112,93,1444,13.466666666666669
2018-02-23 15:00:00,1,8696,8802,-106,55,1886,13.466666666666669
2018-02-23 15:00:00,2,10516,10422,94,99,430,13.466666666666669
2018-02-23 16:00:00,1,8476,8262,214,33,430,13.466666666666669
2018-02-23 16:00:00,2,9814,9990,-176,119,1086,13.466666666666669
2018-02-23 17:00:00,1,8500,8478,22,40,800,17.46666666666667
2018-02-23 17:00:00,2,9656,9450,206,88,538,13.466666666666669
2018-02-23 18:00:00,1,6432,6372,60,38,342,12.466666666666669
2018-02-23 18:00:00,2,5682,5670,12,85,434,12.466666666666669
2018-02-23 19:00:00,1,9656,9720,-64,58,1516,12.466666666666669
2018-02-23 19:00:00,2,9250,9072,178,120,660,12.466666666666669
2018-02-23 20:00:00,1,8824,8586,238,44,542,12.466666666666669
2018-02-23 20:00:00,2,9112,9126,-14,60,4248,12.466666666666669
2018-02-23 21:00:00,1,8052,7956,96,40,436,15.466666666666669
2018-02-23 21:00:00,2,9560,9396,164,75,348,12.466666666666669
2018-02-23 22:00:00,1,9688,9612,76,15,3656,12.466666666666669
2018-02-23 22:00:00,2,6656,6804,-148,172,512,12.466666666666669
2018-02-23 23:00:00,1,8843,8748,95,1,14340,12.466666666666669
2018-02-23 23:00:00,2,9324,9018,306,179,1174,12.466666666666669
2018-02-24 00:00:00,1,2957,3474,-517,204,814,12.466666666666669
2018-02-24 00:00:00,2,9768,9774,-6,153,818,12.466666666666669
2018-02-24 01:00:00,1,4826,4158,668,144,1414,12.466666666666669
2018-02-24 01:00:00,2,5812,5670,142,1,22856,12.466666666666669
2018-02-24 02:00:00,1,9048,8964,84,125,1228,12.466666666666669
2018-02-24 03:00:00,1,7068,6966,102,155,610,13.466666666666669
2018-02-24 04:00:00,1,8020,8046,-26,154,1334,13.466666666666669
2018-02-24 05:00:00,1,8312,8100,212,99,2850,13.466666666666669
2018-02-24 06:00:00,1,7308,7290,18,106,514,13.466666666666669
2018-02-24 07:00:00,1,6093,5940,153,141,1258,13.466666666666669
2018-02-24 08:00:00,1,8928,8856,72,7,438,15.466666666666669
2018-02-24 09:00:00,1,7024,6912,112,183,652,13.466666666666669
2018-02-24 10:00:00,1,4494,4932,-438,29,4276,13.466666666666669
2018-02-24 11:00:00,1,6388,5778,610,161,536,13.466666666666669
2018-02-24 12:00:00,1,6904,6804,100,14,1210,13.466666666666669
2018-02-24 12:00:00,2,328,72,256,19,27600,13.466666666666669
2018-02-24 13:00:00,1,8784,8748,36,28,278,13.466666666666669
2018-02-24 13:00:00,2,3628,3924,-296,23,208,13.466666666666669
2018-02-24 14:00:00,1,9132,9126,6,48,304,15.466666666666669
2018-02-24 14:00:00,2,3861,3294,567,35,608,13.466666666666669
2018-02-24 15:00:00,1,672,1080,-408,58,470,13.466666666666669
2018-02-24 15:00:00,2,7783,7776,7,35,202,13.466666666666669
2018-02-24 16:00:00,2,10508,10422,86,32,326,13.466666666666669
2018-02-24 17:00:00,2,10124,10098,26,20,516,13.466666666666669
2018-02-24 18:00:00,2,9283,9234,49,47,354,15.466666666666669
2018-02-24 19:00:00,2,9720,9666,54,95,1402,15.466666666666669
2018-02-24 20:00:00,2,10544,10422,122,49,864,15.466666666666669
2018-02-24 21:00:00,2,10128,10098,30,127,820,14.466666666666669
2018-02-24 22:00:00,1,1452,1026,426,25,362,14.466666666666669
2018-02-24 22:00:00,2,10276,10314,-38,160,516,14.466666666666669
2018-02-24 23:00:00,1,6727,6642,85,29,198,14.466666666666669
2018-02-24 23:00:00,2,8368,8262,106,145,630,14.466666666666669
2018-02-25 00:00:00,1,8360,8262,98,44,278,14.466666666666669
2018-02-25 00:00:00,2,10156,10098,58,161,494,14.466666666666669
2018-02-25 01:00:00,1,9172,9126,46,39,208,17.46666666666667
2018-02-25 01:00:00,2,10306,10260,46,140,494,16.96666666666667
2018-02-25 02:00:00,1,8816,8748,68,27,232,16.96666666666667
2018-02-25 02:00:00,2,10256,10206,50,152,358,16.96666666666667
2018-02-25 03:00:00,1,9380,9342,38,29,554,16.96666666666667
2018-02-25 03:00:00,2,10456,10422,34,140,670,16.96666666666667
2018-02-25 04:00:00,1,9340,9288,52,36,238,16.96666666666667
2018-02-25 04:00:00,2,10487,10422,65,140,472,16.96666666666667
2018-02-25 05:00:00,1,9588,9558,30,44,546,19.633333333333336
2018-02-25 05:00:00,2,9440,9342,98,118,452,16.96666666666667
2018-02-25 06:00:00,1,8832,8802,30,86,1466,16.96666666666667
2018-02-25 06:00:00,2,10339,10368,-29,149,544,16.96666666666667
2018-02-25 07:00:00,1,9380,9288,92,46,2444,16.96666666666667
2018-02-25 07:00:00,2,9516,9504,12,161,486,16.96666666666667
2018-02-25 08:00:00,1,9440,9396,44,18,438,16.96666666666667
2018-02-25 08:00:00,2,6760,6696,64,144,2532,16.96666666666667
2018-02-25 09:00:00,1,9200,9126,74,43,286,16.96666666666667
2018-02-25 09:00:00,2,3392,3294,98,27,3194,16.96666666666667
2018-02-25 10:00:00,1,9240,9288,-48,41,368,16.96666666666667
2018-02-25 10:00:00,2,9920,9936,-16,30,1406,16.96666666666667
2018-02-25 11:00:00,1,6544,6642,-98,41,600,16.96666666666667
2018-02-25 11:00:00,2,9896,9828,68,90,632,16.96666666666667
2018-02-25 12:00:00,1,916,864,52,42,544,16.96666666666667
2018-02-25 12:00:00,2,10056,9990,66,95,1300,16.96666666666667
2018-02-25 13:00:00,1,4004,3942,62,53,338,19.633333333333336
2018-02-25 13:00:00,2,9299,9180,119,130,730,16.96666666666667
2018-02-25 14:00:00,1,8443,8262,181,40,850,16.96666666666667
2018-02-25 14:00:00,2,9780,9774,6,130,1226,16.96666666666667
2018-02-25 15:00:00,1,7014,6912,102,23,120,16.96666666666667
2018-02-25 15:00:00,2,9820,9828,-8,85,1210,16.96666666666667
2018-02-25 16:00:00,1,8547,8640,-93,38,382,16.96666666666667
2018-02-25 16:00:00,2,8790,8748,42,125,992,16.96666666666667
2018-02-25 17:00:00,1,7232,7074,158,49,496,19.633333333333336
2018-02-25 17:00:00,2,10388,10314,74,126,1074,16.96666666666667
2018-02-25 18:00:00,1,7252,7236,16,63,344,16.96666666666667
2018-02-25 18:00:00,2,10040,9936,104,111,978,16.96666666666667
2018-02-25 19:00:00,1,7920,7830,90,28,176,16.96666666666667
2018-02-25 19:00:00,2,9840,9774,66,151,904,16.96666666666667
2018-02-25 20:00:00,1,7388,7398,-10,24,4212,16.96666666666667
2018-02-25 20:00:00,2,9820,9774,46,143,506,16.96666666666667
2018-02-25 21:00:00,1,7816,7722,94,26,208,16.96666666666667
2018-02-25 21:00:00,2,10587,10584,3,155,586,16.96666666666667
2018-02-25 22:00:00,1,8101,7992,109,47,226,16.96666666666667
2018-02-25 22:00:00,2,3526,4050,-524,210,740,16.96666666666667
2018-02-25 23:00:00,1,9212,9180,32,40,570,16.96666666666667
2018-02-25 23:00:00,2,5222,4698,524,161,424,16.96666666666667
2018-02-26 00:00:00,1,9008,8964,44,30,214,16.96666666666667
2018-02-26 00:00:00,2,10404,10368,36,166,502,16.96666666666667
2018-02-26 01:00:00,1,8455,8370,85,27,280,19.633333333333336
2018-02-26 01:00:00,2,9448,9342,106,167,512,16.96666666666667
2018-02-26 02:00:00,1,9544,9558,-14,23,220,16.96666666666667
2018-02-26 02:00:00,2,10500,10422,78,171,2714,16.96666666666667
2018-02-26 03:00:00,1,9148,9288,-140,21,486,16.96666666666667
2018-02-26 03:00:00,2,10288,10206,82,4,2924,16.96666666666667
2018-02-26 04:00:00,1,9268,9018,250,21,676,16.96666666666667
2018-02-26 04:00:00,2,10488,10476,12,24,2150,16.96666666666667
2018-02-26 05:00:00,1,7434,7956,-522,38,510,19.633333333333336
2018-02-26 05:00:00,2,10236,10152,84,115,1044,16.96666666666667
2018-02-26 06:00:00,2,8548,8478,70,27,234,16.96666666666667
2018-02-26 07:00:00,1,678,162,516,129,766,16.96666666666667
2018-02-26 07:00:00,2,9348,9396,-48,118,782,16.96666666666667
2018-02-26 08:00:00,1,7387,7236,151,142,1092,16.96666666666667
2018-02-26 08:00:00,2,10472,10368,104,47,382,16.96666666666667
2018-02-26 09:00:00,1,8635,8532,103,115,740,16.96666666666667
2018-02-26 09:00:00,2,8616,8532,84,40,810,16.96666666666667
2018-02-26 10:00:00,1,7272,7236,36,92,1108,16.96666666666667
2018-02-26 10:00:00,2,9916,9882,34,29,1186,16.96666666666667
2018-02-26 11:00:00,1,8987,8964,23,89,1090,16.96666666666667
2018-02-26 11:00:00,2,8531,8424,107,28,260,16.96666666666667
2018-02-26 12:00:00,1,7176,7074,102,92,440,16.96666666666667
2018-02-26 12:00:00,2,7588,7830,-242,39,1206,16.96666666666667
2018-02-26 13:00:00,1,7580,7506,74,97,392,16.96666666666667
2018-02-26 13:00:00,2,10388,10206,182,23,238,19.633333333333336
2018-02-26 14:00:00,1,9592,9504,88,95,464,16.96666666666667
2018-02-26 14:00:00,2,7234,7128,106,70,456,16.96666666666667
2018-02-26 15:00:00,1,9796,9774,22,71,440,16.96666666666667
2018-02-26 15:00:00,2,10488,10368,120,56,558,16.96666666666667
2018-02-26 16:00:00,1,9572,9504,68,112,632,16.96666666666667
2018-02-26 16:00:00,2,9612,9612,0,74,538,16.96666666666667
2018-02-26 17:00:00,1,9568,9504,64,95,710,16.96666666666667
2018-02-26 17:00:00,2,9444,9342,102,85,3170,19.633333333333336
2018-02-26 18:00:00,1,8784,8748,36,106,480,18.033333333333335
2018-02-26 18:00:00,2,9448,9396,52,39,604,18.033333333333335
2018-02-26 19:00:00,1,8762,8640,122,92,578,18.033333333333335
2018-02-26 19:00:00,2,5540,5724,-184,27,200,18.033333333333335
2018-02-26 20:00:00,1,9467,9450,17,83,826,18.033333333333335
2018-02-26 20:00:00,2,4938,4644,294,38,566,18.033333333333335
2018-02-26 21:00:00,1,9092,9126,-34,52,2548,18.033333333333335
2018-02-26 21:00:00,2,10588,10584,4,36,260,18.033333333333335
2018-02-26 22:00:00,1,8608,8532,76,95,632,18.033333333333335
2018-02-26 22:00:00,2,9200,9180,20,39,652,18.033333333333335
2018-02-26 23:00:00,1,3130,3564,-434,91,654,18.033333333333335
2018-02-26 23:00:00,2,10498,10584,-86,27,2974,18.033333333333335
2018-02-27 00:00:00,1,8778,8154,624,92,494,18.033333333333335
2018-02-27 00:00:00,2,9044,8748,296,22,334,18.033333333333335
2018-02-27 01:00:00,1,9172,9126,46,119,628,18.033333333333335
2018-02-27 01:00:00,2,1828,1980,-152,56,388,20.033333333333335
2018-02-27 02:00:00,1,9420,9450,-30,99,486,18.033333333333335
2018-02-27 02:00:00,2,10136,9882,254,31,180,18.033333333333335
2018-02-27 03:00:00,1,8960,8802,158,99,3384,18.033333333333335
2018-02-27 03:00:00,2,9791,9720,71,29,242,18.033333333333335
2018-02-27 04:00:00,1,9384,9396,-12,201,37726,18.033333333333335
2018-02-27 04:00:00,2,10515,10530,-15,52,806,18.033333333333335
2018-02-27 05:00:00,1,1180,1134,46,56,494,18.033333333333335
2018-02-27 05:00:00,2,10458,10314,144,61,434,20.033333333333335
2018-02-27 06:00:00,1,3052,3186,-134,46,820,18.033333333333335
2018-02-27 06:00:00,2,8740,8748,-8,33,504,18.033333333333335
2018-02-27 07:00:00,2,9568,9504,64,55,534,18.033333333333335
2018-02-27 08:00:00,2,9654,9612,42,28,690,18.033333333333335
2018-02-27 09:00:00,2,8273,8208,65,23,284,18.033333333333335
2018-02-27 10:00:00,2,9383,9342,41,35,458,18.033333333333335
2018-02-27 11:00:00,2,9471,9396,75,27,158,18.033333333333335
2018-02-27 12:00:00,2,8992,8964,28,17,300,18.033333333333335
2018-02-27 13:00:00,2,10340,10260,80,26,290,18.033333333333335
2018-02-27 14:00:00,2,9664,9558,106,96,558,18.033333333333335
2018-02-27 15:00:00,2,10618,10638,-20,36,242,18.033333333333335
2018-02-27 16:00:00,1,804,702,102,52,1926,18.033333333333335
2018-02-27 16:00:00,2,10242,10206,36,33,324,18.033333333333335
2018-02-27 17:00:00,1,8796,8802,-6,64,1344,18.033333333333335
2018-02-27 17:00:00,2,10424,10314,110,30,216,18.033333333333335
2018-02-27 18:00:00,1,5048,4968,80,91,968,20.033333333333335
2018-02-27 18:00:00,2,10158,10152,6,52,960,18.033333333333335
2018-02-27 19:00:00,1,6848,6858,-10,85,1180,18.033333333333335
2018-02-27 19:00:00,2,10548,10530,18,61,582,18.033333333333335
2018-02-27 20:00:00,1,8514,8478,36,137,836,18.033333333333335
2018-02-27 20:00:00,2,8390,8370,20,39,722,18.033333333333335
2018-02-27 21:00:00,1,6768,6642,126,149,442,18.033333333333335
2018-02-27 21:00:00,2,8910,8802,108,32,568,18.033333333333335
2018-02-27 22:00:00,1,8187,8046,141,155,410,20.033333333333335
2018-02-27 22:00:00,2,8838,8856,-18,35,984,18.033333333333335
2018-02-27 23:00:00,1,9475,9450,25,130,714,17.033333333333335
2018-02-27 23:00:00,2,9520,9396,124,40,404,18.033333333333335
2018-02-28 00:00:00,1,9564,9504,60,169,464,18.033333333333335
2018-02-28 00:00:00,2,8524,8316,208,36,2636,18.033333333333335
2018-02-28 01:00:00,1,8620,8586,34,243,604,18.033333333333335
2018-02-28 01:00:00,2,9300,9396,-96,27,260,18.033333333333335
2018-02-28 02:00:00,1,9336,9288,48,147,1082,18.033333333333335
2018-02-28 02:00:00,2,5434,5976,-542,43,888,18.033333333333335
2018-02-28 03:00:00,1,8780,8748,32,104,1274,18.033333333333335
2018-02-28 03:00:00,2,7638,7020,618,35,224,18.033333333333335
2018-02-28 04:00:00,1,7596,7506,90,159,476,18.033333333333335
2018-02-28 04:00:00,2,8876,8856,20,81,552,18.033333333333335
2018-02-28 05:00:00,1,6752,6696,56,111,878,18.033333333333335
2018-02-28 05:00:00,2,9956,9936,20,38,520,18.033333333333335
2018-02-28 06:00:00,1,9284,9234,50,48,494,20.033333333333335
2018-02-28 06:00:00,2,9384,9342,42,47,474,18.033333333333335
2018-02-28 07:00:00,1,8156,8100,56,59,598,18.033333333333335
2018-02-28 07:00:00,2,9508,9450,58,38,2246,18.033333333333335
2018-02-28 08:00:00,1,9560,9504,56,51,1094,18.033333333333335
2018-02-28 08:00:00,2,9715,9720,-5,52,696,18.033333333333335
2018-02-28 09:00:00,1,9404,9288,116,50,282,18.033333333333335
2018-02-28 09:00:00,2,4284,4158,126,76,2542,18.033333333333335
2018-02-28 10:00:00,1,7479,7452,27,71,846,20.033333333333335
2018-02-28 10:00:00,2,9067,8964,103,35,1490,18.366666666666667
2018-02-28 11:00:00,1,10164,10044,120,73,794,18.366666666666667
2018-02-28 11:00:00,2,4568,4590,-22,34,856,19.366666666666667
2018-02-28 12:00:00,1,8816,8802,14,58,376,19.366666666666667
2018-02-28 12:00:00,2,5248,5022,226,57,1018,19.366666666666667
2018-02-28 13:00:00,1,8144,8046,98,93,504,19.366666666666667
2018-02-28 13:00:00,2,8312,8316,-4,55,508,19.366666666666667
2018-02-28 14:00:00,1,9912,9882,30,79,674,19.366666666666667
2018-02-28 14:00:00,2,8176,8208,-32,85,408,19.366666666666667
2018-02-28 15:00:00,1,9464,9342,122,75,662,19.366666666666667
2018-02-28 15:00:00,2,9247,9126,121,35,316,19.366666666666667
2018-02-28 16:00:00,1,9148,9234,-86,60,750,19.366666666666667
2018-02-28 16:00:00,2,9856,9774,82,40,546,19.366666666666667
2018-02-28 17:00:00,1,9060,8910,150,30,40392,19.366666666666667
2018-02-28 17:00:00,2,10112,10098,14,31,390,19.366666666666667
2018-02-28 18:00:00,1,8606,8640,-34,37,624,21.366666666666667
2018-02-28 18:00:00,2,9488,9396,92,27,232,19.366666666666667
2018-02-28 19:00:00,1,3516,3564,-48,34,29166,19.366666666666667
2018-02-28 19:00:00,2,9996,9990,6,26,698,19.366666666666667
2018-02-28 20:00:00,2,9200,9234,-34,13,502,19.366666666666667
2018-02-28 21:00:00,2,10532,10314,218,57,1696,19.366666666666667
2018-02-28 22:00:00,2,5794,5994,-200,37,534,19.366666666666667
2018-03-01 06:00:00,1,3068,2808,260,3,4496,19.366666666666667
2018-03-01 06:00:00,2,2948,2808,140,32,862,21.366666666666667
2018-03-01 07:00:00,1,5257,5400,-143,17,980,23.366666666666667
2018-03-01 07:00:00,2,9428,9342,86,30,498,23.366666666666667
2018-03-01 08:00:00,1,0,126,-126,18,322,23.366666666666667
2018-03-01 08:00:00,2,8196,8154,42,37,802,23.366666666666667
2018-03-01 09:00:00,1,5814,5292,522,35,462,23.366666666666667
2018-03-01 09:00:00,2,9684,9666,18,29,334,23.366666666666667
2018-03-01 10:00:00,1,9707,9504,203,37,560,23.366666666666667
2018-03-01 10:00:00,2,8772,8802,-30,14,490,23.366666666666667
2018-03-01 11:00:00,1,9620,9612,8,31,672,23.366666666666667
2018-03-01 11:00:00,2,9972,9774,198,30,644,23.366666666666667
2018-03-01 12:00:00,1,10071,10044,27,20,116840,23.366666666666667
2018-03-01 12:00:00,2,9624,9666,-42,26,486,23.366666666666667
2018-03-01 13:00:00,1,8324,8190,134,23,452,23.366666666666667
2018-03-01 13:00:00,2,9198,9072,126,27,236,23.366666666666667
2018-03-01 14:00:00,1,3930,4428,-498,31,670,23.366666666666667
2018-03-01 14:00:00,2,9680,9558,122,30,432,27.366666666666667
2018-03-01 15:00:00,2,9720,9666,54,36,792,23.366666666666667
2018-03-01 16:00:00,2,10412,10422,-10,27,132556,23.366666666666667
2018-03-01 17:00:00,2,9111,8964,147,1,36598,23.366666666666667
2018-03-01 18:00:00,2,9751,9828,-77,25,1316,23.366666666666667
2018-03-01 19:00:00,2,8944,8802,142,18,1876,23.366666666666667
2018-03-01 20:00:00,2,5322,5886,-564,22,394,23.366666666666667
