Line,ProductDescription,DateTime_Out,Feed,OutputGood,Scrap,Error_Count,Sum_Duration,Avg_Staff
1,Liraglutid 1.8 mg,2018-01-02 23:00:00,2230,1674,556,31,608,3.5
1,Liraglutid 1.8 mg,2018-01-03 00:00:00,7460,7398,62,47,726,3.5
1,Liraglutid 1.8 mg,2018-01-03 01:00:00,8324,8208,116,24,474,3
1,Liraglutid 1.8 mg,2018-01-03 02:00:00,9796,9828,-32,49,312,3
1,Liraglutid 1.8 mg,2018-01-03 03:00:00,9632,9288,344,52,342,3
1,Liraglutid 1.8 mg,2018-01-03 04:00:00,9899,9828,71,26,318,3
1,Liraglutid 1.8 mg,2018-01-03 05:00:00,8460,8532,-72,58,678,3
1,Liraglutid 1.8 mg,2018-01-03 06:00:00,6335,6048,287,49,1348,3
1,Liraglutid 1.8 mg,2018-01-03 07:00:00,8443,8424,19,55,648,3
1,Liraglutid 1.8 mg,2018-01-03 08:00:00,9244,9126,118,57,484,3
1,Liraglutid 1.8 mg,2018-01-03 09:00:00,7912,7722,190,67,944,3
1,Liraglutid 1.8 mg,2018-01-03 10:00:00,8352,8262,90,42,644,3
1,Liraglutid 1.8 mg,2018-01-03 11:00:00,9771,9666,105,40,384,3
1,Liraglutid 1.8 mg,2018-01-03 12:00:00,7632,7452,180,41,718,3
1,Liraglutid 1.8 mg,2018-01-03 13:00:00,8544,8424,120,56,658,3
1,Liraglutid 1.8 mg,2018-01-03 14:00:00,6661,6588,73,79,1314,3
1,Liraglutid 1.8 mg,2018-01-03 15:00:00,9024,8856,168,50,590,3
1,Liraglutid 1.8 mg,2018-01-03 16:00:00,9207,9072,135,49,422,3
1,Liraglutid 1.8 mg,2018-01-03 17:00:00,8819,8802,17,63,704,3
1,Liraglutid 1.8 mg,2018-01-03 18:00:00,8296,8046,250,39,4198,3
1,Liraglutid 1.8 mg,2018-01-03 21:00:00,8120,8154,-34,1,46,3
1,Liraglutid 1.8 mg,2018-01-03 22:00:00,7980,7722,258,39,754,3
1,Liraglutid 1.8 mg,2018-01-03 23:00:00,9264,9072,192,24,1042,3
1,Liraglutid 1.8 mg,2018-01-04 00:00:00,4488,4320,168,19,900,3
1,Liraglutid 1.8 mg,2018-01-04 01:00:00,7796,7614,182,31,1908,3
1,Liraglutid 1.8 mg,2018-01-04 02:00:00,9419,9342,77,32,1502,3
1,Liraglutid 1.8 mg,2018-01-04 03:00:00,8223,7938,285,60,416,3
1,Liraglutid 1.8 mg,2018-01-04 04:00:00,9356,9126,230,69,846,3
1,Liraglutid 1.8 mg,2018-01-04 05:00:00,9904,9882,22,29,580,3
1,Liraglutid 1.8 mg,2018-01-04 06:00:00,9168,9126,42,24,376,3
1,Liraglutid 1.8 mg,2018-01-04 07:00:00,5104,4914,190,46,662,3
1,Liraglutid 1.8 mg,2018-01-04 08:00:00,684,540,144,14,17022,3
1,Liraglutid 1.8 mg,2018-01-04 09:00:00,7967,7884,83,43,330,3
1,Liraglutid 1.8 mg,2018-01-04 10:00:00,2358,2376,-18,24,190,3
1,Liraglutid 1.8 mg,2018-01-04 11:00:00,152,162,-10,33,1002,3
1,Liraglutid 1.8 mg,2018-01-04 12:00:00,5791,5724,67,46,1030,3
1,Liraglutid 1.8 mg,2018-01-04 13:00:00,8924,8748,176,43,430,3
1,Liraglutid 1.8 mg,2018-01-04 14:00:00,8240,8262,-22,28,6306,3
1,Liraglutid 1.8 mg,2018-01-04 15:00:00,5650,6120,-470,12,842,3
1,NovoMix 30 GLY (CCH),2018-01-04 17:00:00,6066,5616,450,22,758,3
1,NovoMix 30 GLY (CCH),2018-01-04 18:00:00,8280,8100,180,53,978,3
1,NovoMix 30 GLY (CCH),2018-01-04 19:00:00,8100,8046,54,35,364,3
1,NovoMix 30 GLY (CCH),2018-01-04 20:00:00,9710,9558,152,35,308,3
1,NovoMix 30 GLY (CCH),2018-01-04 21:00:00,9584,9504,80,29,894,2.5
1,NovoMix 30 GLY (CCH),2018-01-04 22:00:00,8263,8316,-53,73,280,2
1,NovoMix 30 GLY (CCH),2018-01-04 23:00:00,10224,10152,72,25,688,2
1,NovoMix 30 GLY (CCH),2018-01-05 00:00:00,8868,8748,120,18,4292,2
1,NovoMix 30 GLY (CCH),2018-01-05 01:00:00,6256,6156,100,5,948,2
1,NovoMix 30 GLY (CCH),2018-01-05 02:00:00,52,54,-2,20,448,2
1,NovoMix 30 GLY (CCH),2018-01-05 03:00:00,9400,9414,-14,35,362,2
1,NovoMix 30 GLY (CCH),2018-01-05 04:00:00,10104,10044,60,61,454,2
1,NovoMix 30 GLY (CCH),2018-01-05 05:00:00,9430,9396,34,73,530,2
1,NovoMix 30 GLY (CCH),2018-01-05 06:00:00,9128,9018,110,99,2680,2
1,NovoMix 30 GLY (CCH),2018-01-05 07:00:00,6946,7416,-470,2,3796,2
1,Liraglutid 1.8 mg,2018-01-05 14:00:00,3868,3510,358,22,4638,2.33333333333333
1,Liraglutid 1.8 mg,2018-01-05 15:00:00,9980,9828,152,9,1310,2.33333333333333
1,Liraglutid 1.8 mg,2018-01-05 16:00:00,9836,9774,62,39,304,2.5
1,Liraglutid 1.8 mg,2018-01-05 17:00:00,10056,10098,-42,26,420,2.5
1,Liraglutid 1.8 mg,2018-01-05 18:00:00,10152,10098,54,32,316,2.5
1,Liraglutid 1.8 mg,2018-01-05 19:00:00,10044,9936,108,90,290,2.5
1,Liraglutid 1.8 mg,2018-01-05 20:00:00,9471,9396,75,48,342,2.5
1,Liraglutid 1.8 mg,2018-01-05 21:00:00,9724,9666,58,49,408,2.5
1,Liraglutid 1.8 mg,2018-01-05 22:00:00,9744,9612,132,75,360,2.5
1,Liraglutid 1.8 mg,2018-01-05 23:00:00,8756,8802,-46,31,402,2.5
1,Liraglutid 1.8 mg,2018-01-06 00:00:00,9192,9180,12,32,32686,2.5
1,Liraglutid 1.8 mg,2018-01-06 01:00:00,9974,9774,200,36,686,2.5
1,Liraglutid 1.8 mg,2018-01-06 02:00:00,9795,9774,21,36,612,2.5
1,Liraglutid 1.8 mg,2018-01-06 03:00:00,9199,9126,73,27,398,2.5
1,Liraglutid 1.8 mg,2018-01-06 04:00:00,8941,8802,139,49,428,2.5
1,Liraglutid 1.8 mg,2018-01-06 05:00:00,9019,9018,1,38,514,2.5
1,Liraglutid 1.8 mg,2018-01-06 06:00:00,9779,9612,167,47,588,2.5
1,Liraglutid 1.8 mg,2018-01-06 07:00:00,8950,9018,-68,25,368,2.5
1,Liraglutid 1.8 mg,2018-01-06 08:00:00,8556,8424,132,33,328,2.5
1,Liraglutid 1.8 mg,2018-01-06 09:00:00,8040,7938,102,27,660,2.5
1,Liraglutid 1.8 mg,2018-01-06 10:00:00,7520,7560,-40,15,866,2.5
1,Liraglutid 1.8 mg,2018-01-06 11:00:00,9672,9450,222,51,812,2.5
1,Liraglutid 1.8 mg,2018-01-06 12:00:00,8204,8316,-112,28,162,2.5
1,Liraglutid 1.8 mg,2018-01-06 13:00:00,10436,10260,176,27,492,2.5
1,Liraglutid 1.8 mg,2018-01-06 14:00:00,8767,8640,127,40,180,2.5
1,Liraglutid 1.8 mg,2018-01-06 15:00:00,5945,5886,59,34,902,2.2
1,Liraglutid 1.8 mg,2018-01-06 16:00:00,8596,8532,64,20,58206,2
1,Liraglutid 1.8 mg,2018-01-06 17:00:00,7914,7938,-24,30,1582,2
1,Liraglutid 1.8 mg,2018-01-06 18:00:00,7455,7344,111,18,654,2
1,Liraglutid 1.8 mg,2018-01-06 19:00:00,6120,6156,-36,33,674,2
1,Liraglutid 1.8 mg,2018-01-06 20:00:00,9028,8910,118,37,1032,2
1,Liraglutid 1.8 mg,2018-01-06 21:00:00,3063,3186,-123,32,1566,2
1,Liraglutid 1.8 mg,2018-01-06 22:00:00,9095,8856,239,34,326,2
1,Liraglutid 1.8 mg,2018-01-06 23:00:00,10060,9936,124,15,388,2
1,Liraglutid 1.8 mg,2018-01-07 00:00:00,5024,5508,-484,36,492,2
1,Liraglutid 1.8 mg,2018-01-07 01:00:00,6966,6318,648,30,326,2
1,Liraglutid 1.8 mg,2018-01-07 02:00:00,8999,8964,35,31,2682,2
1,Liraglutid 1.8 mg,2018-01-07 03:00:00,9440,9288,152,31,394,2
1,Liraglutid 1.8 mg,2018-01-07 04:00:00,8060,7884,176,47,588,2
1,Liraglutid 1.8 mg,2018-01-07 05:00:00,8403,8316,87,50,598,2
1,Liraglutid 1.8 mg,2018-01-07 06:00:00,7828,7830,-2,39,800,2
1,Liraglutid 1.8 mg,2018-01-07 07:00:00,7900,7722,178,93,1016,3
1,Liraglutid 1.8 mg,2018-01-07 08:00:00,9108,9018,90,91,826,3
1,Liraglutid 1.8 mg,2018-01-07 09:00:00,8727,8694,33,88,540,3
1,Liraglutid 1.8 mg,2018-01-07 10:00:00,8742,8748,-6,115,410,3
1,Liraglutid 1.8 mg,2018-01-07 11:00:00,10184,10044,140,115,686,3
1,Liraglutid 1.8 mg,2018-01-07 12:00:00,9712,9666,46,31,250,3
1,Liraglutid 1.8 mg,2018-01-07 13:00:00,9588,9558,30,19,560,3
1,Liraglutid 1.8 mg,2018-01-07 14:00:00,10312,10206,106,27,304,3
1,Liraglutid 1.8 mg,2018-01-07 15:00:00,6880,6804,76,49,236,2.85714285714286
1,Liraglutid 1.8 mg,2018-01-07 16:00:00,9551,9558,-7,48,1356,2
1,Liraglutid 1.8 mg,2018-01-07 17:00:00,9368,9234,134,57,464,2
1,Liraglutid 1.8 mg,2018-01-07 18:00:00,7688,7722,-34,41,462,2
1,Liraglutid 1.8 mg,2018-01-07 19:00:00,5100,5022,78,48,2956,2
1,Liraglutid 1.8 mg,2018-01-07 20:00:00,5479,5400,79,23,312,2
1,Liraglutid 1.8 mg,2018-01-07 21:00:00,7595,7614,-19,44,1756,2
1,Liraglutid 1.8 mg,2018-01-07 22:00:00,6925,6804,121,46,808,2
1,Liraglutid 1.8 mg,2018-01-07 23:00:00,8088,8208,-120,74,810,2
1,Liraglutid 1.8 mg,2018-01-08 00:00:00,5546,5868,-322,40,940,2
1,Liraglutid 0.9 mg,2018-01-08 01:00:00,5506,4860,646,35,3154,2
1,Liraglutid 0.9 mg,2018-01-08 02:00:00,9363,9288,75,28,294,2
1,Liraglutid 0.9 mg,2018-01-08 03:00:00,8624,8424,200,47,446,2
1,Liraglutid 0.9 mg,2018-01-08 04:00:00,8634,8478,156,59,446,2
1,Liraglutid 0.9 mg,2018-01-08 05:00:00,6382,6426,-44,54,714,2
1,Liraglutid 0.9 mg,2018-01-08 06:00:00,6784,6588,196,84,1468,2.6
1,Liraglutid 0.9 mg,2018-01-08 07:00:00,8804,8640,164,35,1240,4
1,Liraglutid 0.9 mg,2018-01-08 08:00:00,9324,9180,144,51,718,4
1,Liraglutid 0.9 mg,2018-01-08 09:00:00,8920,8910,10,60,482,4
1,Liraglutid 0.9 mg,2018-01-08 10:00:00,9176,8964,212,122,604,4
1,Liraglutid 0.9 mg,2018-01-08 11:00:00,9388,9288,100,101,582,4
1,Liraglutid 0.9 mg,2018-01-08 12:00:00,6698,6642,56,67,364,4
1,Liraglutid 0.9 mg,2018-01-08 13:00:00,10095,10044,51,54,1402,4
1,Liraglutid 0.9 mg,2018-01-08 14:00:00,8943,8802,141,62,324,4
1,Liraglutid 0.9 mg,2018-01-08 15:00:00,9863,9720,143,52,650,4
1,Liraglutid 0.9 mg,2018-01-08 16:00:00,7490,7974,-484,56,416,4
1,Liraglutid 1.8 mg,2018-01-08 18:00:00,5087,4698,389,11,578,4
1,Liraglutid 1.8 mg,2018-01-08 19:00:00,9530,9450,80,30,378,4
1,Liraglutid 1.8 mg,2018-01-08 20:00:00,9436,9288,148,46,708,4
1,Liraglutid 1.8 mg,2018-01-08 21:00:00,10376,10260,116,41,494,4
1,Liraglutid 1.8 mg,2018-01-08 22:00:00,10096,10044,52,27,794,4
1,Liraglutid 1.8 mg,2018-01-08 23:00:00,8564,8586,-22,60,486,4
1,Liraglutid 1.8 mg,2018-01-09 00:00:00,9801,9720,81,26,192,4
1,Liraglutid 1.8 mg,2018-01-09 01:00:00,8720,8586,134,42,202,4
1,Liraglutid 1.8 mg,2018-01-09 02:00:00,9963,9882,81,27,192,4
1,Liraglutid 1.8 mg,2018-01-09 03:00:00,8088,7938,150,34,468,4
1,Liraglutid 1.8 mg,2018-01-09 04:00:00,8072,8046,26,34,1812,4
1,Liraglutid 1.8 mg,2018-01-09 05:00:00,7340,7290,50,26,542,4
1,Liraglutid 1.8 mg,2018-01-09 06:00:00,9199,9126,73,21,588,4
1,Liraglutid 1.8 mg,2018-01-09 07:00:00,8916,8910,6,24,1490,4
1,Liraglutid 1.8 mg,2018-01-09 08:00:00,8936,8856,80,43,400,4
1,Liraglutid 1.8 mg,2018-01-09 09:00:00,7980,7830,150,37,296,4
1,Liraglutid 1.8 mg,2018-01-09 10:00:00,4476,4482,-6,23,1034,4
1,Liraglutid 1.8 mg,2018-01-09 11:00:00,9792,9666,126,36,850,4
1,Liraglutid 1.8 mg,2018-01-09 12:00:00,5893,6372,-479,33,188,4
1,Liraglutid 1.8 mg,2018-01-09 13:00:00,5113,4644,469,35,176,4
1,Liraglutid 1.8 mg,2018-01-09 14:00:00,10143,9990,153,45,516,4
1,Liraglutid 1.8 mg,2018-01-09 15:00:00,9276,9234,42,47,716,4
1,Liraglutid 1.8 mg,2018-01-09 16:00:00,9684,9612,72,28,274,3.5
1,Liraglutid 1.8 mg,2018-01-09 17:00:00,8366,8316,50,77,606,3
1,Liraglutid 1.8 mg,2018-01-09 18:00:00,9112,9018,94,36,506,3
1,Liraglutid 1.8 mg,2018-01-09 19:00:00,8578,8586,-8,48,388,3
1,Liraglutid 1.8 mg,2018-01-09 20:00:00,8399,8316,83,25,4706,3
1,Liraglutid 1.8 mg,2018-01-09 21:00:00,9132,9072,60,31,720,3
1,Liraglutid 1.8 mg,2018-01-09 22:00:00,9376,9342,34,63,360,3
1,Liraglutid 1.8 mg,2018-01-09 23:00:00,8824,8694,130,36,374,3
1,Liraglutid 1.8 mg,2018-01-10 00:00:00,8868,8856,12,41,348,3
1,Liraglutid 1.8 mg,2018-01-10 01:00:00,8956,8892,64,31,472,3
1,Liraglutid 1.8 mg,2018-01-10 02:00:00,9924,9882,42,42,778,3
1,Liraglutid 1.8 mg,2018-01-10 03:00:00,9448,9342,106,45,360,3
1,Liraglutid 1.8 mg,2018-01-10 04:00:00,9196,9180,16,39,332,3
1,Liraglutid 1.8 mg,2018-01-10 05:00:00,6211,6102,109,62,972,3
1,Liraglutid 1.8 mg,2018-01-10 06:00:00,8980,9018,-38,38,556,3
1,Liraglutid 1.8 mg,2018-01-10 07:00:00,8812,8748,64,38,456,3
1,Liraglutid 1.8 mg,2018-01-10 08:00:00,8340,8262,78,36,694,3
1,Liraglutid 1.8 mg,2018-01-10 09:00:00,8584,8532,52,61,504,2
1,Liraglutid 1.8 mg,2018-01-10 10:00:00,7650,7560,90,42,880,2
1,Liraglutid 1.8 mg,2018-01-10 11:00:00,7092,7236,-144,30,186,2
1,Liraglutid 1.8 mg,2018-01-10 12:00:00,9003,8694,309,38,1284,2
1,Liraglutid 1.8 mg,2018-01-10 13:00:00,8700,8694,6,34,664,2
1,Liraglutid 1.8 mg,2018-01-10 14:00:00,9520,9396,124,39,306,2
1,Liraglutid 1.8 mg,2018-01-10 15:00:00,7669,7668,1,90,354,2
1,Liraglutid 1.8 mg,2018-01-10 16:00:00,6993,6912,81,39,1966,2
1,Liraglutid 1.8 mg,2018-01-10 17:00:00,4572,4644,-72,46,606,2
1,Liraglutid 1.8 mg,2018-01-10 18:00:00,7919,7830,89,89,732,2
1,Liraglutid 1.8 mg,2018-01-10 19:00:00,7561,7506,55,29,312,2
1,Liraglutid 1.8 mg,2018-01-10 20:00:00,4312,4374,-62,33,206,2
1,Liraglutid 1.8 mg,2018-01-10 21:00:00,620,486,134,77,416,2
1,Liraglutid 1.8 mg,2018-01-10 22:00:00,8936,8856,80,31,444,2
1,Liraglutid 1.8 mg,2018-01-10 23:00:00,9676,9720,-44,40,432,2
1,Liraglutid 1.8 mg,2018-01-11 00:00:00,4690,5148,-458,44,212,2
1,Liraglutid 1.8 mg,2018-01-11 01:00:00,5394,4860,534,65,374,2
1,Liraglutid 1.8 mg,2018-01-11 02:00:00,9056,9018,38,100,870,2
1,Liraglutid 1.8 mg,2018-01-11 03:00:00,9363,9234,129,61,420,2
1,Liraglutid 1.8 mg,2018-01-11 04:00:00,9256,9180,76,43,222,2.66666666666667
1,Liraglutid 1.8 mg,2018-01-11 05:00:00,4466,4428,38,60,312,4
1,Liraglutid 1.8 mg,2018-01-11 06:00:00,7256,7236,20,50,602,4
1,Liraglutid 1.8 mg,2018-01-11 07:00:00,4232,4212,20,128,360,3.5
1,Liraglutid 1.8 mg,2018-01-11 08:00:00,4984,4914,70,83,3448,3
1,Liraglutid 1.8 mg,2018-01-11 09:00:00,3378,3294,84,1,2050,3
1,Liraglutid 1.8 mg,2018-01-11 10:00:00,6012,5994,18,28,648,3
1,Liraglutid 1.8 mg,2018-01-11 11:00:00,3996,3942,54,32,172,3
1,Liraglutid 1.8 mg,2018-01-11 12:00:00,4364,4320,44,48,632,3
1,Liraglutid 1.8 mg,2018-01-11 13:00:00,6609,6588,21,24,4770,3
1,Liraglutid 1.8 mg,2018-01-11 14:00:00,7660,7560,100,4,14,3
1,Liraglutid 1.8 mg,2018-01-11 15:00:00,9516,9504,12,30,412,2.75
1,Liraglutid 1.8 mg,2018-01-11 16:00:00,5040,5022,18,29,270,2.66666666666667
1,Liraglutid 1.8 mg,2018-01-11 17:00:00,5424,5346,78,50,350,2.66666666666667
1,Liraglutid 1.8 mg,2018-01-11 18:00:00,5935,5886,49,53,920,2.66666666666667
1,Liraglutid 1.8 mg,2018-01-11 19:00:00,5551,5562,-11,28,158,2.66666666666667
1,Liraglutid 1.8 mg,2018-01-11 20:00:00,164,108,56,33,370,2.66666666666667
1,Liraglutid 1.8 mg,2018-01-11 21:00:00,9044,8964,80,35,760,2.66666666666667
1,Liraglutid 1.8 mg,2018-01-11 22:00:00,9266,9234,32,21,250,2.66666666666667
1,Liraglutid 1.8 mg,2018-01-11 23:00:00,7352,7398,-46,47,624,2.66666666666667
1,Liraglutid 1.8 mg,2018-01-12 00:00:00,8236,8046,190,32,846,2.66666666666667
1,Liraglutid 1.8 mg,2018-01-12 01:00:00,6624,6534,90,89,1130,2.66666666666667
1,Liraglutid 1.8 mg,2018-01-12 02:00:00,7339,7236,103,36,1454,2.66666666666667
1,Liraglutid 1.8 mg,2018-01-12 03:00:00,8431,8424,7,26,486,2.66666666666667
1,Liraglutid 1.8 mg,2018-01-12 04:00:00,5096,5076,20,27,282,2.66666666666667
1,Liraglutid 1.8 mg,2018-01-12 05:00:00,7732,7614,118,66,494,2.66666666666667
1,Liraglutid 1.8 mg,2018-01-12 06:00:00,7887,7830,57,33,274,2.66666666666667
1,Liraglutid 1.8 mg,2018-01-12 07:00:00,5692,5670,22,42,238,2.66666666666667
1,Liraglutid 1.8 mg,2018-01-12 08:00:00,8980,8910,70,28,268,2.66666666666667
1,Liraglutid 1.8 mg,2018-01-12 09:00:00,9482,9396,86,62,346,2.66666666666667
1,Liraglutid 1.8 mg,2018-01-12 10:00:00,4556,4536,20,51,606,2.66666666666667
1,Liraglutid 1.8 mg,2018-01-12 11:00:00,2968,2916,52,6,3392,2.66666666666667
1,Liraglutid 1.8 mg,2018-01-12 14:00:00,0,108,-108,10,17846,2.66666666666667
1,Liraglutid 1.8 mg,2018-01-12 19:00:00,7096,6912,184,28,254,2.66666666666667
1,Liraglutid 1.8 mg,2018-01-12 20:00:00,8186,8154,32,35,210,2.66666666666667
1,Liraglutid 1.8 mg,2018-01-12 21:00:00,8232,8100,132,18,1404,2.66666666666667
1,Liraglutid 1.8 mg,2018-01-12 22:00:00,8319,8208,111,68,710,2.66666666666667
1,Liraglutid 1.8 mg,2018-01-12 23:00:00,8971,9018,-47,84,866,2.66666666666667
1,Liraglutid 1.8 mg,2018-01-13 00:00:00,8992,8856,136,3,26658,2.66666666666667
1,Liraglutid 1.8 mg,2018-01-13 01:00:00,9460,9396,64,49,644,2.66666666666667
1,Liraglutid 1.8 mg,2018-01-13 02:00:00,4716,5184,-468,48,698,2.66666666666667
1,Liraglutid 1.8 mg,2018-01-13 03:00:00,6948,6372,576,37,502,2.66666666666667
1,Liraglutid 1.8 mg,2018-01-13 04:00:00,9418,9342,76,32,2940,2.66666666666667
1,Liraglutid 1.8 mg,2018-01-13 05:00:00,8363,8262,101,29,406,2.66666666666667
1,Liraglutid 1.8 mg,2018-01-13 06:00:00,7852,7938,-86,59,498,2.66666666666667
1,Liraglutid 1.8 mg,2018-01-13 07:00:00,6852,6588,264,52,862,2.66666666666667
1,Liraglutid 1.8 mg,2018-01-13 08:00:00,7004,6966,38,1,34200,2.66666666666667
1,Liraglutid 1.8 mg,2018-01-13 09:00:00,9492,9396,96,70,1038,2.66666666666667
1,Liraglutid 1.8 mg,2018-01-13 10:00:00,9928,9882,46,52,1238,2.66666666666667
1,Liraglutid 1.8 mg,2018-01-13 11:00:00,8675,8586,89,82,1166,2.66666666666667
1,Liraglutid 1.8 mg,2018-01-13 12:00:00,9670,9558,112,60,472,2.66666666666667
1,Liraglutid 1.8 mg,2018-01-13 13:00:00,9196,9126,70,40,266,2.66666666666667
1,Liraglutid 1.8 mg,2018-01-13 14:00:00,9199,9072,127,52,530,2.66666666666667
1,Liraglutid 1.8 mg,2018-01-13 15:00:00,9808,9828,-20,45,348,2.66666666666667
1,Liraglutid 1.8 mg,2018-01-13 16:00:00,10256,10098,158,51,602,2.66666666666667
1,Liraglutid 1.8 mg,2018-01-13 17:00:00,10160,10098,62,42,324,2.66666666666667
1,Liraglutid 1.8 mg,2018-01-13 18:00:00,9832,9828,4,29,390,2.66666666666667
1,Liraglutid 1.8 mg,2018-01-13 19:00:00,10080,9936,144,1,61058,2.66666666666667
1,Liraglutid 1.8 mg,2018-01-13 20:00:00,9980,9990,-10,43,290,2.66666666666667
1,Liraglutid 1.8 mg,2018-01-13 21:00:00,10025,9882,143,47,262,2.66666666666667
1,Liraglutid 1.8 mg,2018-01-13 22:00:00,9955,9990,-35,42,340,2.66666666666667
1,Liraglutid 1.8 mg,2018-01-13 23:00:00,9876,9720,156,33,296,2.66666666666667
1,Liraglutid 1.8 mg,2018-01-14 00:00:00,9654,9612,42,25,264,2.66666666666667
1,Liraglutid 1.8 mg,2018-01-14 01:00:00,9976,9882,94,32,254,2.66666666666667
1,Liraglutid 1.8 mg,2018-01-14 02:00:00,8664,8532,132,35,412,2.66666666666667
1,Liraglutid 1.8 mg,2018-01-14 03:00:00,9624,9612,12,45,380,2.66666666666667
1,Liraglutid 1.8 mg,2018-01-14 04:00:00,9396,9342,54,50,434,2.66666666666667
1,Liraglutid 1.8 mg,2018-01-14 05:00:00,9744,9720,24,46,424,2.66666666666667
1,Liraglutid 1.8 mg,2018-01-14 06:00:00,10404,10260,144,41,398,2.66666666666667
1,Liraglutid 1.8 mg,2018-01-14 07:00:00,9883,9828,55,29,264,2.66666666666667
1,Liraglutid 1.8 mg,2018-01-14 08:00:00,9369,9342,27,35,340,2.66666666666667
1,Liraglutid 1.8 mg,2018-01-14 09:00:00,8251,8208,43,26,376,2.66666666666667
1,Liraglutid 1.8 mg,2018-01-14 10:00:00,8191,8100,91,28,452,2.66666666666667
1,Liraglutid 1.8 mg,2018-01-14 11:00:00,4508,4950,-442,27,1352,2.66666666666667
1,PenMix 30 (CCH),2018-01-14 12:00:00,2218,1620,598,36,324,2.66666666666667
1,PenMix 30 (CCH),2018-01-14 13:00:00,9456,9342,114,38,234,2.66666666666667
1,PenMix 30 (CCH),2018-01-14 14:00:00,9551,9396,155,32,328,2.66666666666667
1,PenMix 30 (CCH),2018-01-14 15:00:00,10496,10368,128,90,422,2.66666666666667
1,PenMix 30 (CCH),2018-01-14 16:00:00,9776,9666,110,27,142,2.66666666666667
1,PenMix 30 (CCH),2018-01-14 17:00:00,9542,9558,-16,31,564,2.66666666666667
1,PenMix 30 (CCH),2018-01-14 18:00:00,10203,10044,159,58,302,2.66666666666667
1,PenMix 30 (CCH),2018-01-14 19:00:00,10394,10368,26,68,520,2.66666666666667
1,PenMix 30 (CCH),2018-01-14 20:00:00,9546,9504,42,54,678,2.66666666666667
1,PenMix 30 (CCH),2018-01-14 21:00:00,9223,8946,277,60,268,2.66666666666667
1,PenMix 30 (CCH),2018-01-14 22:00:00,9325,9558,-233,38,408,2.66666666666667
1,PenMix 30 (CCH),2018-01-14 23:00:00,2330,1926,404,55,572,2.42857142857143
1,PenMix 30 (CCH),2018-01-14 23:00:00,2330,1926,404,55,572,2.42857142857143
1,PenMix 30 (CCH),2018-01-15 00:00:00,9244,9180,64,75,372,2
1,PenMix 30 (CCH),2018-01-15 01:00:00,9628,9774,-146,49,376,2
1,PenMix 30 (CCH),2018-01-15 02:00:00,5719,5562,157,44,3570,2
1,PenMix 30 (CCH),2018-01-15 03:00:00,9380,9234,146,20,1386,2
1,PenMix 30 (CCH),2018-01-15 04:00:00,9087,9018,69,29,238,2
1,PenMix 30 (CCH),2018-01-15 05:00:00,9123,9126,-3,38,560,2
1,PenMix 30 (CCH),2018-01-15 06:00:00,9440,9396,44,36,328,2
1,PenMix 30 (CCH),2018-01-15 07:00:00,9595,9450,145,59,598,2
1,PenMix 30 (CCH),2018-01-15 08:00:00,9953,9882,71,53,168,2
1,PenMix 30 (CCH),2018-01-15 09:00:00,9227,9234,-7,56,210,2
1,PenMix 30 (CCH),2018-01-15 10:00:00,10164,10044,120,36,4354,2
1,PenMix 30 (CCH),2018-01-15 11:00:00,10351,10260,91,20,120,2
1,PenMix 30 (CCH),2018-01-15 12:00:00,9408,9450,-42,32,98,2
1,PenMix 30 (CCH),2018-01-15 13:00:00,10648,10530,118,36,308,2
1,PenMix 30 (CCH),2018-01-15 14:00:00,10347,10314,33,32,152,2
1,PenMix 30 (CCH),2018-01-15 15:00:00,10884,10800,84,46,244,2
1,PenMix 30 (CCH),2018-01-15 16:00:00,9900,9882,18,45,452,2
1,PenMix 30 (CCH),2018-01-15 17:00:00,10164,10098,66,38,354,2
1,PenMix 30 (CCH),2018-01-15 18:00:00,9392,9342,50,79,274,2
1,PenMix 30 (CCH),2018-01-15 19:00:00,9192,9180,12,71,802,2
1,PenMix 30 (CCH),2018-01-15 20:00:00,3583,3564,19,51,482,2
1,PenMix 30 (CCH),2018-01-15 21:00:00,4523,4482,41,68,454,2
1,PenMix 30 (CCH),2018-01-15 22:00:00,6076,6048,28,34,3770,2
1,PenMix 30 (CCH),2018-01-15 23:00:00,7572,7506,66,41,640,2
1,PenMix 30 (CCH),2018-01-16 00:00:00,9083,9072,11,26,2360,2
1,PenMix 30 (CCH),2018-01-16 01:00:00,9027,9072,-45,47,1712,2
1,PenMix 30 (CCH),2018-01-16 02:00:00,8856,8748,108,52,610,2
1,PenMix 30 (CCH),2018-01-16 03:00:00,8484,8424,60,42,170,2
1,PenMix 30 (CCH),2018-01-16 04:00:00,9487,9558,-71,43,220,2
1,PenMix 30 (CCH),2018-01-16 05:00:00,8015,7830,185,46,100,2
1,PenMix 30 (CCH),2018-01-16 06:00:00,8657,8640,17,96,366,2
1,PenMix 30 (CCH),2018-01-16 07:00:00,8723,8694,29,52,360,2
1,PenMix 30 (CCH),2018-01-16 08:00:00,9635,9558,77,84,390,2
1,PenMix 30 (CCH),2018-01-16 09:00:00,2480,2430,50,70,960,2
1,PenMix 30 (CCH),2018-01-16 10:00:00,10507,10476,31,86,422,2
1,PenMix 30 (CCH),2018-01-16 11:00:00,9916,9882,34,55,168,2
1,PenMix 30 (CCH),2018-01-16 12:00:00,2691,3168,-477,58,388,2
1,Protaphan (CCH),2018-01-16 13:00:00,1690,1080,610,47,712,2
1,Protaphan (CCH),2018-01-16 14:00:00,5680,5454,226,52,1082,2
1,Protaphan (CCH),2018-01-16 15:00:00,4664,4482,182,60,734,2
1,Protaphan (CCH),2018-01-16 16:00:00,1670,2196,-526,47,206,2
1,Liraglutid 1.8 mg,2018-01-16 17:00:00,2350,1782,568,62,542,2
1,Liraglutid 1.8 mg,2018-01-16 18:00:00,3940,3996,-56,84,448,2
1,Liraglutid 1.8 mg,2018-01-16 19:00:00,9194,9072,122,80,574,2
1,Liraglutid 1.8 mg,2018-01-16 20:00:00,4078,3942,136,63,972,2
1,Liraglutid 1.8 mg,2018-01-16 21:00:00,9472,9396,76,74,1530,2
1,Liraglutid 1.8 mg,2018-01-16 22:00:00,8605,8532,73,8,3184,2
1,Liraglutid 1.8 mg,2018-01-16 23:00:00,7039,7236,-197,56,666,2
1,Liraglutid 1.8 mg,2018-01-17 00:00:00,7809,7506,303,67,644,2
1,Liraglutid 1.8 mg,2018-01-17 01:00:00,7554,7560,-6,129,846,2
1,Liraglutid 1.8 mg,2018-01-17 02:00:00,7187,7074,113,23,438,2
1,Liraglutid 1.8 mg,2018-01-17 07:00:00,5012,5022,-10,60,17168,2
1,Liraglutid 1.8 mg,2018-01-17 08:00:00,9192,9126,66,44,228,2
1,Liraglutid 1.8 mg,2018-01-17 09:00:00,9392,9288,104,102,498,2
1,Liraglutid 1.8 mg,2018-01-17 10:00:00,9258,9180,78,73,402,2
1,Liraglutid 1.8 mg,2018-01-17 11:00:00,9454,9450,4,50,480,2
1,Liraglutid 1.8 mg,2018-01-17 12:00:00,8510,8532,-22,77,458,2
1,Liraglutid 1.8 mg,2018-01-17 13:00:00,9832,9720,112,103,830,2
1,Liraglutid 1.8 mg,2018-01-17 14:00:00,8339,8208,131,64,360,2
1,Liraglutid 1.8 mg,2018-01-17 15:00:00,7788,7938,-150,92,812,2
1,Liraglutid 1.8 mg,2018-01-17 16:00:00,8330,8154,176,49,1186,2
1,Liraglutid 1.8 mg,2018-01-17 17:00:00,9683,9558,125,87,648,2
1,Liraglutid 1.8 mg,2018-01-17 18:00:00,10022,9936,86,55,366,2
1,Liraglutid 1.8 mg,2018-01-17 19:00:00,8372,8316,56,70,312,2
1,Liraglutid 1.8 mg,2018-01-17 20:00:00,8631,8532,99,68,870,2
1,Liraglutid 1.8 mg,2018-01-17 21:00:00,9556,9720,-164,99,736,2
1,Liraglutid 1.8 mg,2018-01-17 22:00:00,9708,9450,258,57,506,2
1,Liraglutid 1.8 mg,2018-01-17 23:00:00,1280,1134,146,51,492,2
1,Liraglutid 1.8 mg,2018-01-18 00:00:00,924,1080,-156,9,4198,3
1,Liraglutid 1.8 mg,2018-01-18 01:00:00,8939,9018,-79,5,2652,2
1,Liraglutid 1.8 mg,2018-01-18 02:00:00,6544,6372,172,30,326,2
1,Liraglutid 1.8 mg,2018-01-18 03:00:00,8520,8478,42,89,700,2
1,Liraglutid 1.8 mg,2018-01-18 04:00:00,4807,4752,55,30,582,2
1,Liraglutid 1.8 mg,2018-01-18 05:00:00,9188,9180,8,11,3204,2
1,Liraglutid 1.8 mg,2018-01-18 06:00:00,7111,7020,91,38,348,2
1,Liraglutid 1.8 mg,2018-01-18 07:00:00,9071,8910,161,26,30898,2
1,Liraglutid 1.8 mg,2018-01-18 08:00:00,9560,9450,110,44,614,2
1,Liraglutid 1.8 mg,2018-01-18 09:00:00,9171,9018,153,50,508,2
1,Liraglutid 1.8 mg,2018-01-18 10:00:00,4164,4608,-444,61,638,2
1,Liraglutid 1.8 mg,2018-01-18 14:00:00,1826,1242,584,2,1902,2
1,Liraglutid 1.8 mg,2018-01-18 15:00:00,8543,8262,281,1,7234,2
1,Liraglutid 1.8 mg,2018-01-18 16:00:00,8831,8802,29,45,756,2
1,Liraglutid 1.8 mg,2018-01-18 17:00:00,9962,9774,188,39,712,2
1,Liraglutid 1.8 mg,2018-01-18 18:00:00,9216,9180,36,35,388,2
1,Liraglutid 1.8 mg,2018-01-18 19:00:00,9727,9558,169,38,650,2
1,Liraglutid 1.8 mg,2018-01-18 20:00:00,8586,8532,54,42,302,2
1,Liraglutid 1.8 mg,2018-01-18 21:00:00,9582,9450,132,65,648,2
1,Liraglutid 1.8 mg,2018-01-18 22:00:00,9289,9072,217,57,230,2
1,Liraglutid 1.8 mg,2018-01-18 23:00:00,8726,8856,-130,54,570,2.4
1,Liraglutid 1.8 mg,2018-01-19 00:00:00,9471,9234,237,59,788,4
1,Liraglutid 1.8 mg,2018-01-19 01:00:00,10387,10260,127,42,340,4
1,Liraglutid 1.8 mg,2018-01-19 02:00:00,6396,6858,-462,43,244,4
1,Liraglutid 1.8 mg,2018-01-19 03:00:00,5239,4644,595,36,2256,4
1,Liraglutid 1.8 mg,2018-01-19 04:00:00,9450,9288,162,16,1166,4
1,Liraglutid 1.8 mg,2018-01-19 05:00:00,9243,9180,63,59,406,4
1,Liraglutid 1.8 mg,2018-01-19 06:00:00,7880,7938,-58,13,150,4
1,Liraglutid 1.8 mg,2018-01-19 07:00:00,7138,7074,64,71,688,4
1,Liraglutid 1.8 mg,2018-01-19 08:00:00,6718,6426,292,45,1536,4
1,Liraglutid 1.8 mg,2018-01-19 09:00:00,8819,8856,-37,44,752,4
1,Liraglutid 1.8 mg,2018-01-19 10:00:00,10480,10314,166,115,544,4
1,Liraglutid 1.8 mg,2018-01-19 11:00:00,10044,9936,108,27,212,4
1,Liraglutid 1.8 mg,2018-01-19 12:00:00,7707,7614,93,43,240,4
1,Liraglutid 1.8 mg,2018-01-19 13:00:00,6419,6318,101,25,1070,4
1,Liraglutid 1.8 mg,2018-01-19 14:00:00,7240,7128,112,36,1622,4
1,Liraglutid 1.8 mg,2018-01-19 15:00:00,9806,9774,32,74,1148,4
1,Liraglutid 1.8 mg,2018-01-19 16:00:00,8260,8154,106,41,418,4
1,Liraglutid 1.8 mg,2018-01-19 17:00:00,8636,8694,-58,46,838,4
1,Liraglutid 1.8 mg,2018-01-19 18:00:00,8108,7938,170,124,770,4
1,Liraglutid 1.8 mg,2018-01-19 19:00:00,8059,8046,13,32,746,4
1,Liraglutid 1.8 mg,2018-01-19 20:00:00,10016,9828,188,78,820,4
1,Liraglutid 1.8 mg,2018-01-19 21:00:00,1286,1350,-64,86,344,4
1,Liraglutid 1.8 mg,2018-01-19 22:00:00,6667,6750,-83,16,3244,4
1,Liraglutid 1.8 mg,2018-01-20 06:00:00,680,486,194,33,1308,4
1,Liraglutid 1.8 mg,2018-01-20 07:00:00,6944,6912,32,20,1364,4
1,Liraglutid 1.8 mg,2018-01-20 08:00:00,8992,8910,82,80,1018,4
1,Liraglutid 1.8 mg,2018-01-20 09:00:00,9608,9612,-4,99,436,4
1,Liraglutid 1.8 mg,2018-01-20 10:00:00,9348,9234,114,72,304,4
1,Liraglutid 1.8 mg,2018-01-20 11:00:00,7512,7398,114,59,512,4
1,Liraglutid 1.8 mg,2018-01-20 12:00:00,8806,8694,112,72,934,4
1,Liraglutid 1.8 mg,2018-01-20 13:00:00,8579,8532,47,57,240,4
1,Liraglutid 1.8 mg,2018-01-20 14:00:00,7367,7848,-481,63,780,4
1,Liraglutid 1.8 mg,2018-01-21 06:00:00,1958,1296,662,32,536,4
1,Liraglutid 1.8 mg,2018-01-21 07:00:00,4321,4320,1,3,60,4
1,Liraglutid 1.8 mg,2018-01-21 08:00:00,8972,8910,62,48,1662,4
1,Liraglutid 1.8 mg,2018-01-21 09:00:00,8658,8586,72,34,598,4
1,Liraglutid 1.8 mg,2018-01-21 10:00:00,9301,9234,67,49,640,4
1,Liraglutid 1.8 mg,2018-01-21 11:00:00,8820,8748,72,26,398,4
1,Liraglutid 1.8 mg,2018-01-21 12:00:00,7308,7236,72,43,632,4
1,Liraglutid 1.8 mg,2018-01-21 13:00:00,8336,8262,74,68,1332,4
1,Liraglutid 1.8 mg,2018-01-21 14:00:00,3058,3564,-506,39,610,4
1,Detemir Gly (CCH),2018-01-21 15:00:00,710,108,602,16,5350,4
1,Detemir Gly (CCH),2018-01-21 16:00:00,7903,7884,19,3,26,4
1,Detemir Gly (CCH),2018-01-21 17:00:00,9696,9828,-132,50,988,4
1,Detemir Gly (CCH),2018-01-21 18:00:00,10460,10206,254,43,434,4
1,Detemir Gly (CCH),2018-01-21 19:00:00,8981,8910,71,18,322,4
1,Detemir Gly (CCH),2018-01-21 20:00:00,9579,9558,21,42,526,4
1,Detemir Gly (CCH),2018-01-21 21:00:00,7802,7776,26,39,504,4
1,Detemir Gly (CCH),2018-01-21 22:00:00,8940,8802,138,81,620,4.33333333333333
1,Detemir Gly (CCH),2018-01-21 23:00:00,9735,9720,15,56,550,5
1,Detemir Gly (CCH),2018-01-22 00:00:00,9687,9666,21,49,326,5
1,Detemir Gly (CCH),2018-01-22 01:00:00,10080,9936,144,32,482,5
1,Detemir Gly (CCH),2018-01-22 02:00:00,9850,9774,76,41,210,5
1,Detemir Gly (CCH),2018-01-22 03:00:00,10860,10854,6,48,338,5
1,Detemir Gly (CCH),2018-01-22 04:00:00,10387,10314,73,21,70,5
1,Detemir Gly (CCH),2018-01-22 05:00:00,9472,9450,22,33,220,5
1,Detemir Gly (CCH),2018-01-22 06:00:00,7541,7506,35,61,396,5
1,Detemir Gly (CCH),2018-01-22 07:00:00,8884,8802,82,59,1146,5
1,Detemir Gly (CCH),2018-01-22 08:00:00,10339,10260,79,35,704,5
1,Detemir Gly (CCH),2018-01-22 09:00:00,6091,6048,43,44,268,5
1,Detemir Gly (CCH),2018-01-22 10:00:00,8579,8640,-61,33,1822,5
1,Detemir Gly (CCH),2018-01-22 11:00:00,9106,8964,142,51,550,5
1,Detemir Gly (CCH),2018-01-22 12:00:00,3313,3294,19,75,650,5
1,Detemir Gly (CCH),2018-01-22 13:00:00,8931,8856,75,52,2466,5
1,Detemir Gly (CCH),2018-01-22 14:00:00,9140,9072,68,48,402,5
1,Detemir Gly (CCH),2018-01-22 15:00:00,9892,9774,118,22,114,4.5
1,Detemir Gly (CCH),2018-01-22 16:00:00,6486,7038,-552,25,496,4
1,Detemir Gly (CCH),2018-01-22 18:00:00,9440,9072,368,40,744,3
1,Detemir Gly (CCH),2018-01-22 19:00:00,10560,10368,192,22,564,3
1,Detemir Gly (CCH),2018-01-22 20:00:00,10412,10368,44,22,9008,3
1,Detemir Gly (CCH),2018-01-22 21:00:00,9668,9666,2,29,230,3
1,Detemir Gly (CCH),2018-01-22 22:00:00,6852,6804,48,12,438,4
1,Detemir Gly (CCH),2018-01-22 23:00:00,10580,10530,50,57,722,4
1,Detemir Gly (CCH),2018-01-23 00:00:00,1900,1890,10,20,150,4
1,Detemir Gly (CCH),2018-01-23 01:00:00,5024,4860,164,37,3298,4
1,Detemir Gly (CCH),2018-01-23 02:00:00,8816,8910,-94,39,494,4
1,Detemir Gly (CCH),2018-01-23 03:00:00,9524,9504,20,35,486,4
1,Detemir Gly (CCH),2018-01-23 04:00:00,10164,9990,174,76,598,4
1,Detemir Gly (CCH),2018-01-23 05:00:00,9176,9180,-4,25,920,4
1,Detemir Gly (CCH),2018-01-23 06:00:00,9180,9180,0,76,826,4
1,Detemir Gly (CCH),2018-01-23 07:00:00,1100,1296,-196,23,124,4
1,Detemir Gly (CCH),2018-01-23 10:00:00,108,0,108,24,808,4
1,Detemir Gly (CCH),2018-01-23 12:00:00,16,0,16,15,1410,4
1,Detemir Gly (CCH),2018-01-23 13:00:00,584,702,-118,63,3450,4
1,Detemir Gly (CCH),2018-01-23 14:00:00,8,0,8,3,15754,4
1,Detemir Gly (CCH),2018-01-23 15:00:00,32,0,32,78,362,4
1,Detemir Gly (CCH),2018-01-23 16:00:00,12,0,12,35,2014,4
1,Detemir Gly (CCH),2018-01-23 17:00:00,36,0,36,25,302,4
1,Detemir Gly (CCH),2018-01-23 18:00:00,248,216,32,47,538,4
1,Detemir Gly (CCH),2018-01-23 19:00:00,260,216,44,100,458,4
1,Detemir Gly (CCH),2018-01-23 20:00:00,6232,5994,238,56,582,4
1,Detemir Gly (CCH),2018-01-23 21:00:00,8360,8424,-64,33,368,4
1,Detemir Gly (CCH),2018-01-23 22:00:00,8090,8100,-10,29,398,4.2
1,Detemir Gly (CCH),2018-01-23 23:00:00,8695,8586,109,23,238,5
1,Detemir Gly (CCH),2018-01-24 00:00:00,8051,7884,167,20,474,5
1,Detemir Gly (CCH),2018-01-24 01:00:00,9432,9396,36,30,644,5
1,Detemir Gly (CCH),2018-01-24 02:00:00,10516,10476,40,31,3876,5
1,Detemir Gly (CCH),2018-01-24 03:00:00,9152,9072,80,22,840,5
1,Detemir Gly (CCH),2018-01-24 04:00:00,10046,9990,56,39,676,5
1,Detemir Gly (CCH),2018-01-24 05:00:00,9668,9612,56,23,166,5
1,Detemir Gly (CCH),2018-01-24 06:00:00,9928,9828,100,47,370,4.33333333333333
1,Detemir Gly (CCH),2018-01-24 07:00:00,9004,8964,40,29,214,4
1,Detemir Gly (CCH),2018-01-24 08:00:00,3243,3132,111,68,600,4
1,Detemir Gly (CCH),2018-01-24 09:00:00,9744,9666,78,31,7770,4
1,Detemir Gly (CCH),2018-01-24 10:00:00,8756,8802,-46,83,1374,4
1,Detemir Gly (CCH),2018-01-24 11:00:00,8948,8748,200,77,3488,4
1,Detemir Gly (CCH),2018-01-24 12:00:00,6956,6912,44,43,252,4
1,Detemir Gly (CCH),2018-01-24 13:00:00,7669,8136,-467,63,468,4
1,NovoMix 70 NN2000,2018-01-24 14:00:00,2471,1944,527,74,794,4
1,NovoMix 70 NN2000,2018-01-24 15:00:00,9341,9072,269,56,284,4
1,NovoMix 70 NN2000,2018-01-24 16:00:00,8356,8370,-14,72,944,4
1,NovoMix 70 NN2000,2018-01-24 17:00:00,10216,9990,226,2,4218,4
1,NovoMix 70 NN2000,2018-01-24 18:00:00,8281,8640,-359,25,826,4
1,NovoMix 70 NN2000,2018-01-24 19:00:00,0,18,-18,54,390,4
1,Liraglutid 1.8 mg,2018-01-24 20:00:00,6142,5906,236,29,342,4
1,Liraglutid 1.8 mg,2018-01-24 21:00:00,9808,10302,-494,70,448,4
1,Liraglutid 1.8 mg,2018-01-24 22:00:00,9672,10082,-410,45,1702,4
1,Liraglutid 1.8 mg,2018-01-24 23:00:00,9744,10176,-432,39,432,4
1,Liraglutid 1.8 mg,2018-01-25 00:00:00,9754,10302,-548,28,548,4
1,Liraglutid 1.8 mg,2018-01-25 01:00:00,9568,10046,-478,28,604,4
1,Liraglutid 1.8 mg,2018-01-25 02:00:00,10076,10576,-500,16,216,4
1,Liraglutid 1.8 mg,2018-01-25 03:00:00,6867,7446,-579,28,402,4
1,Liraglutid 1.8 mg,2018-01-25 04:00:00,8736,8963,-227,61,616,4
1,Liraglutid 1.8 mg,2018-01-25 05:00:00,9648,9921,-273,35,1728,4
1,Liraglutid 1.8 mg,2018-01-25 06:00:00,9360,10022,-662,43,552,4
1,Liraglutid 1.8 mg,2018-01-25 07:00:00,7199,7762,-563,11,3780,4
1,Liraglutid 1.8 mg,2018-01-25 08:00:00,9317,9920,-603,46,604,4
1,Liraglutid 1.8 mg,2018-01-25 09:00:00,8794,9614,-820,39,512,4
1,Liraglutid 1.8 mg,2018-01-25 10:00:00,9814,10516,-702,21,360,4
1,Liraglutid 1.8 mg,2018-01-25 11:00:00,9824,10382,-558,19,2456,4
1,Liraglutid 1.8 mg,2018-01-25 12:00:00,7892,8700,-808,44,1324,4
1,Liraglutid 1.8 mg,2018-01-25 13:00:00,8032,8646,-614,26,3244,4
1,Liraglutid 1.8 mg,2018-01-25 14:00:00,7512,8274,-762,24,462,3.33333333333333
1,Liraglutid 1.8 mg,2018-01-25 15:00:00,10124,10788,-664,29,322,3
1,Liraglutid 1.8 mg,2018-01-25 16:00:00,8939,9880,-941,43,240,3
1,Liraglutid 1.8 mg,2018-01-25 17:00:00,8098,8856,-758,24,306,3
1,Liraglutid 1.8 mg,2018-01-25 18:00:00,9920,10518,-598,46,510,3
1,Liraglutid 1.8 mg,2018-01-25 19:00:00,9292,9998,-706,21,338,3
1,Liraglutid 1.8 mg,2018-01-25 20:00:00,9888,10394,-506,51,1642,3
1,Liraglutid 1.8 mg,2018-01-25 21:00:00,9786,10344,-558,90,818,3
1,Liraglutid 1.8 mg,2018-01-25 22:00:00,9051,9660,-609,2,4304,3
1,Liraglutid 1.8 mg,2018-01-25 23:00:00,10066,10546,-480,31,1030,3
1,Liraglutid 1.8 mg,2018-01-26 00:00:00,8236,8718,-482,32,808,3
1,Liraglutid 1.8 mg,2018-01-26 01:00:00,9388,10022,-634,38,478,3
1,Liraglutid 1.8 mg,2018-01-26 02:00:00,7907,8538,-631,36,550,3
1,Liraglutid 1.8 mg,2018-01-26 03:00:00,1708,1938,-230,25,648,3
1,Liraglutid 1.8 mg,2018-01-26 07:00:00,6416,6591,-175,22,2680,3
1,Liraglutid 1.8 mg,2018-01-26 08:00:00,8416,8562,-146,22,282,3
1,Liraglutid 1.8 mg,2018-01-26 09:00:00,8132,8162,-30,23,142,3
1,Liraglutid 1.8 mg,2018-01-26 10:00:00,9032,9110,-78,32,856,3
1,Liraglutid 1.8 mg,2018-01-26 11:00:00,7368,7539,-171,42,1804,3
1,Liraglutid 1.8 mg,2018-01-26 12:00:00,9391,9432,-41,60,444,3
1,Liraglutid 1.8 mg,2018-01-26 13:00:00,8808,8914,-106,44,342,3
1,Liraglutid 1.8 mg,2018-01-26 14:00:00,9604,9740,-136,75,546,3
1,Liraglutid 1.8 mg,2018-01-26 15:00:00,9275,9395,-120,40,246,3
1,Liraglutid 1.8 mg,2018-01-26 16:00:00,10444,10479,-35,39,420,3
1,Liraglutid 1.8 mg,2018-01-26 17:00:00,9332,9464,-132,41,294,3
1,Liraglutid 1.8 mg,2018-01-26 18:00:00,9172,9199,-27,83,408,3
1,Liraglutid 1.8 mg,2018-01-26 19:00:00,9547,9600,-53,5,10,3
1,Liraglutid 1.8 mg,2018-01-26 20:00:00,8960,9095,-135,40,646,3
1,Liraglutid 1.8 mg,2018-01-26 21:00:00,9628,9665,-37,46,826,3
1,Liraglutid 1.8 mg,2018-01-26 22:00:00,9836,9980,-144,62,1496,3
1,Liraglutid 1.8 mg,2018-01-26 23:00:00,9344,9412,-68,107,1264,3
1,Liraglutid 1.8 mg,2018-01-27 00:00:00,8196,8335,-139,79,730,3
1,Liraglutid 1.8 mg,2018-01-27 01:00:00,7788,7895,-107,52,594,3
1,Liraglutid 1.8 mg,2018-01-27 02:00:00,5609,5796,-187,29,356,3
1,Liraglutid 1.8 mg,2018-01-27 03:00:00,5980,6091,-111,26,250,3
1,Liraglutid 1.8 mg,2018-01-27 04:00:00,7291,7450,-159,51,540,3
1,Liraglutid 1.8 mg,2018-01-27 05:00:00,8075,8315,-240,72,634,3
1,Liraglutid 1.8 mg,2018-01-27 06:00:00,9196,9165,31,46,334,3
1,Liraglutid 1.8 mg,2018-01-27 07:00:00,9896,9960,-64,64,458,3.5
1,Liraglutid 1.8 mg,2018-01-27 08:00:00,9424,9494,-70,30,204,4
1,Liraglutid 1.8 mg,2018-01-27 09:00:00,9984,10125,-141,31,64,4
1,Liraglutid 1.8 mg,2018-01-27 10:00:00,7572,7632,-60,79,706,4
1,Liraglutid 1.8 mg,2018-01-27 11:00:00,468,584,-116,44,734,4
1,Liraglutid 1.8 mg,2018-01-27 12:00:00,7415,7652,-237,34,58474,4
1,Liraglutid 1.8 mg,2018-01-27 13:00:00,8632,8589,43,53,556,4
1,Liraglutid 1.8 mg,2018-01-27 14:00:00,6876,6707,169,38,546,4
1,Liraglutid 1.8 mg,2018-01-27 22:00:00,1824,1572,252,49,668,4
1,Liraglutid 1.8 mg,2018-01-27 23:00:00,8908,8875,33,46,782,4
1,Liraglutid 1.8 mg,2018-01-28 00:00:00,8204,8233,-29,58,316,4
1,Liraglutid 1.8 mg,2018-01-28 01:00:00,9108,9138,-30,63,896,4
1,Liraglutid 1.8 mg,2018-01-28 02:00:00,2628,2979,-351,1,2326,4
1,Liraglutid 1.8 mg,2018-01-28 03:00:00,7971,7668,303,44,310,4
1,Liraglutid 1.8 mg,2018-01-28 04:00:00,8884,8802,82,25,1302,4
1,Liraglutid 1.8 mg,2018-01-28 05:00:00,9563,9504,59,36,256,4
1,Liraglutid 1.8 mg,2018-01-28 06:00:00,8349,8190,159,42,1248,4
1,Liraglutid 1.8 mg,2018-01-28 07:00:00,9872,9882,-10,41,366,4
1,Liraglutid 1.8 mg,2018-01-28 08:00:00,10092,10044,48,53,380,4
1,Liraglutid 1.8 mg,2018-01-28 09:00:00,10036,9990,46,61,190,4
1,Liraglutid 1.8 mg,2018-01-28 10:00:00,9896,10044,-148,52,316,4
1,Liraglutid 1.8 mg,2018-01-28 11:00:00,10388,10098,290,65,836,4
1,Liraglutid 1.8 mg,2018-01-28 12:00:00,10072,9990,82,63,488,4
1,Liraglutid 1.8 mg,2018-01-28 13:00:00,8936,9126,-190,62,1280,4
1,Liraglutid 1.8 mg,2018-01-28 14:00:00,8928,8640,288,64,2838,4
1,Liraglutid 1.8 mg,2018-01-28 15:00:00,7226,7398,-172,59,392,4
1,Liraglutid 1.8 mg,2018-01-28 16:00:00,1807,1620,187,59,586,4
1,Liraglutid 1.8 mg,2018-01-28 17:00:00,9560,9504,56,57,584,4
1,Liraglutid 1.8 mg,2018-01-28 18:00:00,9180,9180,0,52,446,4
1,Liraglutid 1.8 mg,2018-01-28 19:00:00,9068,8910,158,108,406,4
1,Liraglutid 1.8 mg,2018-01-28 20:00:00,9460,9396,64,40,396,4
1,Liraglutid 1.8 mg,2018-01-28 21:00:00,9771,9774,-3,54,302,4
1,Liraglutid 1.8 mg,2018-01-28 22:00:00,9668,9612,56,64,798,4
1,Liraglutid 1.8 mg,2018-01-28 23:00:00,10099,10044,55,50,796,4
1,Liraglutid 1.8 mg,2018-01-29 00:00:00,8656,8586,70,101,710,4
1,Liraglutid 1.8 mg,2018-01-29 01:00:00,7586,7506,80,33,630,4
1,Liraglutid 1.8 mg,2018-01-29 02:00:00,8720,8694,26,39,322,4
1,Liraglutid 1.8 mg,2018-01-29 03:00:00,9166,9126,40,47,294,4
1,Liraglutid 1.8 mg,2018-01-29 04:00:00,9696,9666,30,41,898,4
1,Liraglutid 1.8 mg,2018-01-29 05:00:00,9344,9234,110,55,2704,4
1,Liraglutid 1.8 mg,2018-01-29 06:00:00,7412,7398,14,47,688,4
1,Liraglutid 1.8 mg,2018-01-29 07:00:00,2699,2538,161,31,1508,4
1,Liraglutid 1.8 mg,2018-01-29 08:00:00,8508,8478,30,43,546,4
1,Liraglutid 1.8 mg,2018-01-29 09:00:00,5656,5670,-14,13,3654,4
1,Liraglutid 1.8 mg,2018-01-29 10:00:00,8720,8586,134,20,418,4
1,Liraglutid 1.8 mg,2018-01-29 11:00:00,5076,5022,54,57,1680,4
1,Liraglutid 1.8 mg,2018-01-29 12:00:00,4576,4590,-14,54,582,4
1,Liraglutid 1.8 mg,2018-01-29 13:00:00,5648,5400,248,5,3462,4
1,Liraglutid 1.8 mg,2018-01-29 14:00:00,9312,9288,24,23,670,4
1,Liraglutid 1.8 mg,2018-01-29 15:00:00,610,684,-74,51,1240,4
1,Liraglutid 1.8 mg,2018-01-29 16:00:00,8667,8478,189,35,488,4
1,Liraglutid 1.8 mg,2018-01-29 17:00:00,7105,7074,31,59,1074,4
1,Liraglutid 1.8 mg,2018-01-29 18:00:00,9739,9612,127,43,960,4
1,Liraglutid 1.8 mg,2018-01-29 19:00:00,7480,7398,82,50,592,4
1,Liraglutid 1.8 mg,2018-01-29 20:00:00,6631,6480,151,81,712,4
1,Liraglutid 1.8 mg,2018-01-29 21:00:00,9098,9018,80,51,434,4
1,Liraglutid 1.8 mg,2018-01-29 22:00:00,8385,8316,69,78,888,4
1,Liraglutid 1.8 mg,2018-01-29 23:00:00,9838,9774,64,43,382,4
1,Liraglutid 1.8 mg,2018-01-30 00:00:00,7706,7668,38,59,458,4
1,Liraglutid 1.8 mg,2018-01-30 01:00:00,9939,9720,219,77,690,4
1,Liraglutid 1.8 mg,2018-01-30 02:00:00,9795,9774,21,82,564,4
1,Liraglutid 1.8 mg,2018-01-30 03:00:00,7491,7398,93,69,476,4
1,Liraglutid 1.8 mg,2018-01-30 04:00:00,8184,8046,138,101,30698,4
1,Liraglutid 1.8 mg,2018-01-30 05:00:00,9183,9126,57,81,354,4
1,Liraglutid 1.8 mg,2018-01-30 06:00:00,5502,5238,264,47,468,4
1,Liraglutid 1.8 mg,2018-01-30 15:00:00,6807,6696,111,19,300,4
1,Liraglutid 1.8 mg,2018-01-30 16:00:00,8392,8316,76,38,464,4
1,Liraglutid 1.8 mg,2018-01-30 17:00:00,3859,3726,133,43,294,4
1,Liraglutid 1.8 mg,2018-01-30 18:00:00,8691,8478,213,42,726,4
1,Liraglutid 1.8 mg,2018-01-30 19:00:00,9535,9504,31,66,788,4
1,Liraglutid 1.8 mg,2018-01-30 20:00:00,8680,8424,256,49,632,4
1,Liraglutid 1.8 mg,2018-01-30 21:00:00,8252,8154,98,53,996,4
1,Liraglutid 1.8 mg,2018-01-30 22:00:00,8783,8694,89,54,1594,4
1,Liraglutid 1.8 mg,2018-01-30 23:00:00,6763,6588,175,29,620,4
1,Liraglutid 1.8 mg,2018-01-31 00:00:00,5951,5886,65,37,658,4
1,Liraglutid 1.8 mg,2018-01-31 01:00:00,9260,9072,188,42,420,4
1,Liraglutid 1.8 mg,2018-01-31 02:00:00,8848,8730,118,57,578,4
1,Liraglutid 1.8 mg,2018-01-31 03:00:00,8871,8748,123,28,710,4
1,Liraglutid 1.8 mg,2018-01-31 04:00:00,9084,8964,120,48,1230,4
1,Liraglutid 1.8 mg,2018-01-31 05:00:00,8604,8370,234,67,3146,3
1,Liraglutid 1.8 mg,2018-01-31 06:00:00,7114,7020,94,7,122,2
1,Liraglutid 1.8 mg,2018-01-31 07:00:00,9119,9180,-61,29,3358,2
1,Liraglutid 1.8 mg,2018-01-31 08:00:00,3004,2700,304,13,172,3
1,Liraglutid 1.8 mg,2018-01-31 09:00:00,9147,9072,75,48,762,3
1,Liraglutid 1.8 mg,2018-01-31 10:00:00,1684,1620,64,70,3240,3
1,Liraglutid 1.8 mg,2018-01-31 11:00:00,7476,7398,78,39,340,3
1,Liraglutid 1.8 mg,2018-01-31 12:00:00,5505,5922,-417,79,1158,3
1,Liraglutid 1.8 mg,2018-01-31 13:00:00,4969,4482,487,69,1868,3
1,Liraglutid 1.8 mg,2018-01-31 14:00:00,6980,6642,338,52,572,3
1,Liraglutid 1.8 mg,2018-01-31 15:00:00,5216,5238,-22,65,536,3
1,Liraglutid 1.8 mg,2018-01-31 16:00:00,8735,8640,95,86,784,3
1,Liraglutid 1.8 mg,2018-01-31 17:00:00,9023,8838,185,61,766,3
1,Liraglutid 1.8 mg,2018-01-31 18:00:00,8108,7992,116,42,468,3
1,Liraglutid 1.8 mg,2018-01-31 19:00:00,8444,8460,-16,51,562,3
1,Liraglutid 1.8 mg,2018-01-31 20:00:00,9247,9036,211,55,798,3
1,Liraglutid 1.8 mg,2018-01-31 21:00:00,8847,8748,99,45,464,3
1,Liraglutid 1.8 mg,2018-01-31 22:00:00,5594,5346,248,53,1198,3
1,Liraglutid 1.8 mg,2018-01-31 23:00:00,7272,7182,90,35,836,3
1,Liraglutid 1.8 mg,2018-02-01 00:00:00,6552,6426,126,26,1892,3
1,Liraglutid 1.8 mg,2018-02-01 01:00:00,8132,8046,86,44,570,3
1,Liraglutid 1.8 mg,2018-02-01 02:00:00,5032,4860,172,34,236,3
1,Liraglutid 1.8 mg,2018-02-01 03:00:00,8008,7938,70,50,232,3
1,Liraglutid 1.8 mg,2018-02-01 04:00:00,9815,9720,95,88,3472,3
1,Liraglutid 1.8 mg,2018-02-01 05:00:00,9688,9504,184,27,918,3
1,Liraglutid 1.8 mg,2018-02-01 06:00:00,6671,6588,83,33,474,3
1,Liraglutid 1.8 mg,2018-02-01 07:00:00,1108,1080,28,24,218,3
1,Liraglutid 1.8 mg,2018-02-01 08:00:00,4164,3996,168,42,1656,3
1,Liraglutid 1.8 mg,2018-02-01 09:00:00,9584,9504,80,35,374,3
1,Liraglutid 1.8 mg,2018-02-01 10:00:00,5968,5778,190,40,804,3
1,Liraglutid 1.8 mg,2018-02-01 11:00:00,9308,9126,182,54,648,3
1,Liraglutid 1.8 mg,2018-02-01 12:00:00,9308,9072,236,45,730,3
1,Liraglutid 1.8 mg,2018-02-01 13:00:00,5545,5346,199,44,568,3
1,Liraglutid 1.8 mg,2018-02-01 14:00:00,8569,8424,145,41,364,3
1,Liraglutid 1.8 mg,2018-02-01 15:00:00,8812,8802,10,40,274,3
1,Liraglutid 1.8 mg,2018-02-01 16:00:00,5962,5832,130,46,562,3
1,Liraglutid 1.8 mg,2018-02-01 17:00:00,7376,7020,356,55,808,3
1,Liraglutid 1.8 mg,2018-02-01 18:00:00,7716,7560,156,62,306,3
1,Liraglutid 1.8 mg,2018-02-01 19:00:00,7125,7074,51,37,432,3
1,Liraglutid 1.8 mg,2018-02-01 20:00:00,3388,3240,148,24,30236,3
1,Liraglutid 1.8 mg,2018-02-01 21:00:00,9554,9396,158,40,296,3
1,Liraglutid 1.8 mg,2018-02-01 22:00:00,7748,7776,-28,33,456,3
1,Liraglutid 1.8 mg,2018-02-01 23:00:00,5420,5238,182,36,630,3
1,Liraglutid 1.8 mg,2018-02-02 00:00:00,9834,9720,114,36,1520,3
1,Liraglutid 1.8 mg,2018-02-02 01:00:00,8392,8262,130,1,6142,3
1,Liraglutid 1.8 mg,2018-02-02 02:00:00,8912,8694,218,23,246,3
1,Liraglutid 1.8 mg,2018-02-02 03:00:00,8240,8208,32,1,3042,3
1,Liraglutid 1.8 mg,2018-02-02 04:00:00,6226,6048,178,34,4024,3
1,Liraglutid 1.8 mg,2018-02-02 05:00:00,6944,7326,-382,15,504,3
1,NovoMix 30 GLY (CCH),2018-02-02 08:00:00,1711,1242,469,35,442,3
1,NovoMix 30 GLY (CCH),2018-02-02 09:00:00,6076,6102,-26,1,3288,3
1,NovoMix 30 GLY (CCH),2018-02-02 13:00:00,576,432,144,40,442,3
1,NovoMix 30 GLY (CCH),2018-02-02 14:00:00,8036,7884,152,35,682,3
1,NovoMix 30 GLY (CCH),2018-02-02 15:00:00,8024,8046,-22,30,4412,3
1,NovoMix 30 GLY (CCH),2018-02-02 16:00:00,7700,7560,140,20,248,3
1,NovoMix 30 GLY (CCH),2018-02-02 17:00:00,664,864,-200,59,1430,3
1,NovoMix 30 GLY (CCH),2018-02-02 18:00:00,10252,9936,316,59,326,3
1,NovoMix 30 GLY (CCH),2018-02-02 19:00:00,9572,9504,68,58,524,3
1,NovoMix 30 GLY (CCH),2018-02-02 20:00:00,10428,10368,60,41,512,3
1,NovoMix 30 GLY (CCH),2018-02-02 21:00:00,9632,9558,74,55,586,3
1,NovoMix 30 GLY (CCH),2018-02-02 22:00:00,9731,9774,-43,61,584,3
1,NovoMix 30 GLY (CCH),2018-02-02 23:00:00,10216,9990,226,56,282,3
1,NovoMix 30 GLY (CCH),2018-02-03 00:00:00,9547,9612,-65,50,216,3
1,NovoMix 30 GLY (CCH),2018-02-03 01:00:00,10224,10044,180,72,690,3
1,NovoMix 30 GLY (CCH),2018-02-03 02:00:00,8207,8208,-1,63,202,3
1,NovoMix 30 GLY (CCH),2018-02-03 03:00:00,9243,9126,117,90,506,3
1,NovoMix 30 GLY (CCH),2018-02-03 04:00:00,7504,7506,-2,72,336,3
1,NovoMix 30 GLY (CCH),2018-02-03 05:00:00,6536,6480,56,69,450,3
1,NovoMix 30 GLY (CCH),2018-02-03 06:00:00,8708,8640,68,33,2940,3
1,NovoMix 30 GLY (CCH),2018-02-03 07:00:00,9720,9666,54,44,494,3
1,NovoMix 30 GLY (CCH),2018-02-03 08:00:00,8324,8208,116,77,400,3
1,NovoMix 30 GLY (CCH),2018-02-03 09:00:00,10008,9990,18,43,2700,3
1,NovoMix 30 GLY (CCH),2018-02-03 10:00:00,7100,7074,26,17,2500,3
1,NovoMix 30 GLY (CCH),2018-02-03 11:00:00,9724,9612,112,40,244,3
1,NovoMix 30 GLY (CCH),2018-02-03 12:00:00,9844,9774,70,65,334,3
1,NovoMix 30 GLY (CCH),2018-02-03 13:00:00,8772,8694,78,74,512,3
1,NovoMix 30 GLY (CCH),2018-02-03 14:00:00,10011,9936,75,74,432,3
1,NovoMix 30 GLY (CCH),2018-02-03 15:00:00,9159,9180,-21,86,332,3
1,NovoMix 30 GLY (CCH),2018-02-03 16:00:00,9896,9774,122,72,1280,3
1,NovoMix 30 GLY (CCH),2018-02-03 17:00:00,10056,9990,66,71,428,3
1,NovoMix 30 GLY (CCH),2018-02-03 18:00:00,9168,9126,42,78,336,3
1,NovoMix 30 GLY (CCH),2018-02-03 19:00:00,10628,10530,98,80,908,3
1,NovoMix 30 GLY (CCH),2018-02-03 20:00:00,8756,8694,62,49,744,3
1,NovoMix 30 GLY (CCH),2018-02-03 21:00:00,8252,8262,-10,39,194,3
1,NovoMix 30 GLY (CCH),2018-02-03 22:00:00,4768,5256,-488,54,338,3
1,NovoMix 30 GLY (CCH),2018-02-03 23:00:00,7516,3888,3628,42,510,3
1,NovoMix 30 GLY (CCH),2018-02-04 00:00:00,10784,10638,146,61,274,3
1,NovoMix 30 GLY (CCH),2018-02-04 01:00:00,9564,9558,6,37,436,3
1,NovoMix 30 GLY (CCH),2018-02-04 02:00:00,9300,9072,228,32,454,3
1,NovoMix 30 GLY (CCH),2018-02-04 03:00:00,9676,9558,118,38,386,3
1,NovoMix 30 GLY (CCH),2018-02-04 04:00:00,10872,10854,18,41,1428,3
1,NovoMix 30 GLY (CCH),2018-02-04 05:00:00,6068,5922,146,42,1842,3
1,NovoMix 30 GLY (CCH),2018-02-04 06:00:00,10064,9990,74,35,1604,3
1,NovoMix 30 GLY (CCH),2018-02-04 07:00:00,9576,9504,72,30,186,3
1,NovoMix 30 GLY (CCH),2018-02-04 08:00:00,9708,9666,42,34,250,3
1,NovoMix 30 GLY (CCH),2018-02-04 09:00:00,8268,8208,60,48,440,3
1,NovoMix 30 GLY (CCH),2018-02-04 10:00:00,4044,3996,48,31,236,3.5
1,NovoMix 30 GLY (CCH),2018-02-04 11:00:00,10012,9936,76,41,312,3.5
1,NovoMix 30 GLY (CCH),2018-02-04 12:00:00,10680,10638,42,40,694,3.66666666666667
1,NovoMix 30 GLY (CCH),2018-02-04 13:00:00,9752,9666,86,42,778,4
1,NovoMix 30 GLY (CCH),2018-02-04 14:00:00,9304,9180,124,41,3358,4.6
1,NovoMix 30 GLY (CCH),2018-02-04 15:00:00,9818,9720,98,22,110,3
1,NovoMix 30 GLY (CCH),2018-02-04 16:00:00,9942,9882,60,41,520,3
1,NovoMix 30 GLY (CCH),2018-02-04 17:00:00,9712,9720,-8,51,624,3
1,NovoMix 30 GLY (CCH),2018-02-04 18:00:00,10696,10692,4,41,1022,3
1,NovoMix 30 GLY (CCH),2018-02-04 19:00:00,10123,9990,133,48,278,3
1,NovoMix 30 GLY (CCH),2018-02-04 20:00:00,10095,9936,159,57,368,3
1,NovoMix 30 GLY (CCH),2018-02-04 21:00:00,9712,9612,100,53,146,3
1,NovoMix 30 GLY (CCH),2018-02-04 22:00:00,10052,9990,62,65,304,3
1,NovoMix 30 GLY (CCH),2018-02-04 23:00:00,8563,8478,85,55,634,3
1,NovoMix 30 GLY (CCH),2018-02-05 00:00:00,9312,9126,186,71,288,3
1,NovoMix 30 GLY (CCH),2018-02-05 01:00:00,9852,9882,-30,56,312,3
1,NovoMix 30 GLY (CCH),2018-02-05 02:00:00,10328,10206,122,53,236,3
1,NovoMix 30 GLY (CCH),2018-02-05 03:00:00,9508,9396,112,95,484,3
1,NovoMix 30 GLY (CCH),2018-02-05 04:00:00,10138,10044,94,58,292,3
1,NovoMix 30 GLY (CCH),2018-02-05 05:00:00,9756,9774,-18,55,284,3
1,NovoMix 30 GLY (CCH),2018-02-05 06:00:00,9124,8910,214,60,1184,3
1,NovoMix 30 GLY (CCH),2018-02-05 07:00:00,3600,3564,36,34,1844,3
1,NovoMix 30 GLY (CCH),2018-02-05 08:00:00,1302,1836,-534,41,540,3
1,NovoMix 30 GLY (CCH),2018-02-05 09:00:00,3178,2646,532,40,764,3
1,NovoMix 30 GLY (CCH),2018-02-05 10:00:00,5806,5724,82,41,250,3
1,NovoMix 30 GLY (CCH),2018-02-05 11:00:00,9788,9720,68,48,946,3
1,NovoMix 30 GLY (CCH),2018-02-05 12:00:00,8359,8100,259,9,4410,3
1,NovoMix 30 GLY (CCH),2018-02-05 13:00:00,8412,8316,96,18,1204,3
1,NovoMix 30 GLY (CCH),2018-02-05 14:00:00,6196,6102,94,28,578,3
1,NovoMix 30 GLY (CCH),2018-02-05 15:00:00,3512,3294,218,60,472,3
1,NovoMix 30 GLY (CCH),2018-02-05 16:00:00,3142,3222,-80,60,496,4
1,Detemir Gly (CCH),2018-02-05 16:00:00,3142,3222,-80,60,496,4
1,Detemir Gly (CCH),2018-02-05 17:00:00,8888,8640,248,29,184,4
1,Detemir Gly (CCH),2018-02-05 18:00:00,7291,7074,217,18,2766,4
1,Detemir Gly (CCH),2018-02-05 19:00:00,8259,8262,-3,52,216,4
1,Detemir Gly (CCH),2018-02-05 20:00:00,5804,5616,188,36,516,4
1,Detemir Gly (CCH),2018-02-05 21:00:00,7876,7776,100,62,360,4
1,Detemir Gly (CCH),2018-02-05 22:00:00,9824,9720,104,32,362,4
1,Detemir Gly (CCH),2018-02-05 23:00:00,8484,8316,168,64,384,4
1,Detemir Gly (CCH),2018-02-06 00:00:00,9624,9558,66,60,708,4
1,Detemir Gly (CCH),2018-02-06 01:00:00,9640,9558,82,63,1862,4
1,Detemir Gly (CCH),2018-02-06 02:00:00,4372,4266,106,22,786,4
1,Detemir Gly (CCH),2018-02-06 03:00:00,7420,7020,400,75,376,4
1,Detemir Gly (CCH),2018-02-06 04:00:00,8740,8640,100,102,608,4
1,Detemir Gly (CCH),2018-02-06 05:00:00,9560,9612,-52,81,482,4
1,Detemir Gly (CCH),2018-02-06 06:00:00,9072,8802,270,73,476,4
1,Detemir Gly (CCH),2018-02-06 07:00:00,7953,7992,-39,62,862,4
1,Detemir Gly (CCH),2018-02-06 08:00:00,38,378,-340,88,630,4
1,NovoMix 50 NN2000,2018-02-06 09:00:00,7712,7128,584,95,468,4
1,NovoMix 50 NN2000,2018-02-06 10:00:00,8116,7938,178,66,1002,4
1,NovoMix 50 NN2000,2018-02-06 11:00:00,8507,8370,137,84,440,4
1,NovoMix 50 NN2000,2018-02-06 12:00:00,5927,5868,59,98,744,4
1,NovoMix 50 NN2000,2018-02-06 13:00:00,1528,2052,-524,56,820,4
1,no product,2018-02-06 14:00:00,4965,4266,699,63,442,4
1,no product,2018-02-06 15:00:00,10052,9936,116,63,234,4
1,no product,2018-02-06 16:00:00,8456,8262,194,39,598,4
1,no product,2018-02-06 17:00:00,8700,8640,60,85,292,4
1,no product,2018-02-06 18:00:00,9286,9072,214,62,460,4
1,no product,2018-02-06 19:00:00,9111,8964,147,66,284,4
1,no product,2018-02-06 20:00:00,873,1422,-549,61,238,4
1,Liraglutid 1.8 mg,2018-02-06 22:00:00,6832,6588,244,61,256,3.8
1,Liraglutid 1.8 mg,2018-02-06 23:00:00,2440,2376,64,41,214,3.5
1,Liraglutid 1.8 mg,2018-02-07 00:00:00,2188,2160,28,68,582,3.5
1,Liraglutid 1.8 mg,2018-02-07 01:00:00,6903,6750,153,42,372,3.5
1,Liraglutid 1.8 mg,2018-02-07 02:00:00,10142,10098,44,40,3092,3.5
1,Liraglutid 1.8 mg,2018-02-07 03:00:00,10256,10098,158,26,1316,3.5
1,Liraglutid 1.8 mg,2018-02-07 04:00:00,8108,8046,62,39,1744,3.5
1,Liraglutid 1.8 mg,2018-02-07 05:00:00,8371,8262,109,44,1112,3.5
1,Liraglutid 1.8 mg,2018-02-07 06:00:00,7095,7074,21,47,4596,3.5
1,Liraglutid 1.8 mg,2018-02-07 07:00:00,5658,5454,204,7,62,3.5
1,Liraglutid 1.8 mg,2018-02-07 08:00:00,9351,9342,9,54,478,3.5
1,Liraglutid 1.8 mg,2018-02-07 09:00:00,1624,1602,22,35,1780,3.5
1,Liraglutid 1.8 mg,2018-02-07 10:00:00,572,378,194,79,1038,3.5
1,Liraglutid 1.8 mg,2018-02-07 11:00:00,5456,5400,56,52,578,3.5
1,Liraglutid 1.8 mg,2018-02-07 12:00:00,7428,7344,84,50,896,3.5
1,Liraglutid 1.8 mg,2018-02-07 13:00:00,8420,8370,50,64,1194,3.5
1,Liraglutid 1.8 mg,2018-02-07 14:00:00,7479,7398,81,29,230,3.5
1,Liraglutid 1.8 mg,2018-02-07 15:00:00,7176,7074,102,54,474,3.5
1,Liraglutid 1.8 mg,2018-02-07 16:00:00,6591,6426,165,57,380,3.5
1,Liraglutid 1.8 mg,2018-02-07 17:00:00,8531,8424,107,52,580,3.5
1,Liraglutid 1.8 mg,2018-02-07 18:00:00,8471,8424,47,70,532,3.5
1,Liraglutid 1.8 mg,2018-02-07 19:00:00,8904,8748,156,60,388,3.5
1,Liraglutid 1.8 mg,2018-02-07 20:00:00,7997,7776,221,61,578,3.5
1,Liraglutid 1.8 mg,2018-02-07 21:00:00,8260,8316,-56,74,1272,3.5
1,Liraglutid 1.8 mg,2018-02-07 22:00:00,8901,8640,261,49,620,3.5
1,Liraglutid 1.8 mg,2018-02-07 23:00:00,5778,5670,108,62,742,3.5
1,Liraglutid 1.8 mg,2018-02-08 00:00:00,8899,8856,43,43,1248,3.5
1,Liraglutid 1.8 mg,2018-02-08 01:00:00,7781,7776,5,99,1020,3.5
1,Liraglutid 1.8 mg,2018-02-08 02:00:00,4889,4698,191,62,1276,3.5
1,Liraglutid 1.8 mg,2018-02-08 03:00:00,7593,7614,-21,40,826,3.5
1,Liraglutid 1.8 mg,2018-02-08 04:00:00,6360,6102,258,36,670,3.5
1,Liraglutid 1.8 mg,2018-02-08 05:00:00,8232,8154,78,57,684,3.5
1,Liraglutid 1.8 mg,2018-02-08 06:00:00,8956,8892,64,49,684,3.5
1,Liraglutid 1.8 mg,2018-02-08 07:00:00,8274,8208,66,52,1494,3.5
1,Liraglutid 1.8 mg,2018-02-08 08:00:00,8976,8964,12,51,1466,3.5
1,Liraglutid 1.8 mg,2018-02-08 09:00:00,6061,5994,67,20,1586,3.5
1,Liraglutid 1.8 mg,2018-02-08 10:00:00,6372,6372,0,50,1028,3.5
1,Liraglutid 1.8 mg,2018-02-08 11:00:00,5204,5130,74,37,522,3.5
1,Liraglutid 1.8 mg,2018-02-08 12:00:00,7830,7776,54,34,1444,3.5
1,Liraglutid 1.8 mg,2018-02-08 13:00:00,8240,8208,32,32,2418,3.5
1,Liraglutid 1.8 mg,2018-02-08 14:00:00,6424,6318,106,2,3110,3.5
1,Liraglutid 1.8 mg,2018-02-08 15:00:00,4764,5238,-474,20,928,3.5
1,PenMix 30 (CCH),2018-02-08 17:00:00,7928,7866,62,16,216,3.5
1,PenMix 30 (CCH),2018-02-08 18:00:00,9635,9612,23,34,234,3.5
1,PenMix 30 (CCH),2018-02-08 19:00:00,10338,10314,24,66,1914,3.5
1,PenMix 30 (CCH),2018-02-08 20:00:00,10340,10260,80,96,2120,3.5
1,PenMix 30 (CCH),2018-02-08 21:00:00,5396,5508,-112,18,204,3.5
1,PenMix 30 (CCH),2018-02-08 22:00:00,3251,2916,335,38,630,3.5
1,PenMix 30 (CCH),2018-02-08 23:00:00,10431,10260,171,29,996,3.5
1,PenMix 30 (CCH),2018-02-09 00:00:00,9344,9396,-52,31,364,3.5
1,PenMix 30 (CCH),2018-02-09 01:00:00,7788,7506,282,20,768,3.5
1,PenMix 30 (CCH),2018-02-09 02:00:00,10004,9882,122,12,218,3.5
1,PenMix 30 (CCH),2018-02-09 03:00:00,8524,8370,154,46,10818,3.5
1,PenMix 30 (CCH),2018-02-09 04:00:00,10424,10422,2,1,9372,3.5
1,PenMix 30 (CCH),2018-02-09 05:00:00,6628,6642,-14,2,7708,3.5
1,PenMix 30 (CCH),2018-02-09 08:00:00,3256,3348,-92,36,560,3.5
1,PenMix 30 (CCH),2018-02-09 09:00:00,172,54,118,35,340,3.5
1,PenMix 30 (CCH),2018-02-09 10:00:00,1840,1836,4,39,1500,3.5
1,PenMix 30 (CCH),2018-02-09 11:00:00,9320,9126,194,48,954,3.5
1,PenMix 30 (CCH),2018-02-09 12:00:00,9738,9720,18,52,1236,4
1,PenMix 30 (CCH),2018-02-09 13:00:00,8690,8586,104,78,1518,3.5
1,PenMix 30 (CCH),2018-02-09 14:00:00,9227,9126,101,62,536,3
1,PenMix 30 (CCH),2018-02-09 15:00:00,8156,8100,56,92,574,3
1,PenMix 30 (CCH),2018-02-09 16:00:00,8512,8478,34,97,930,3
1,PenMix 30 (CCH),2018-02-09 17:00:00,1532,2034,-502,99,610,3
1,Liraglutid 1.8 mg,2018-02-09 18:00:00,3554,2916,638,132,756,3
1,Liraglutid 1.8 mg,2018-02-09 19:00:00,8575,8424,151,90,434,3
1,Liraglutid 1.8 mg,2018-02-09 20:00:00,9120,9072,48,105,498,3
1,Liraglutid 1.8 mg,2018-02-09 21:00:00,9772,9612,160,95,468,3
1,Liraglutid 1.8 mg,2018-02-09 22:00:00,9284,9234,50,96,794,3
1,Liraglutid 1.8 mg,2018-02-09 23:00:00,9380,9342,38,97,398,3
1,Liraglutid 1.8 mg,2018-02-10 00:00:00,9011,8802,209,99,620,3
1,Liraglutid 1.8 mg,2018-02-10 01:00:00,9836,9774,62,91,392,3
1,Liraglutid 1.8 mg,2018-02-10 02:00:00,9043,8964,79,107,494,3
1,Liraglutid 1.8 mg,2018-02-10 03:00:00,8764,8640,124,96,1062,3
1,Liraglutid 1.8 mg,2018-02-10 04:00:00,4378,4914,-536,12,3682,3
1,Liraglutid 1.8 mg,2018-02-10 05:00:00,6734,6300,434,43,1360,3
1,Liraglutid 1.8 mg,2018-02-10 06:00:00,9472,9234,238,86,472,3
1,Liraglutid 1.8 mg,2018-02-10 07:00:00,9532,9450,82,94,494,3
1,Liraglutid 1.8 mg,2018-02-10 08:00:00,7773,7722,51,117,508,3
1,Liraglutid 1.8 mg,2018-02-10 09:00:00,7123,6966,157,100,272,3
1,Liraglutid 1.8 mg,2018-02-10 10:00:00,8471,8424,47,82,472,3
1,Liraglutid 1.8 mg,2018-02-10 11:00:00,9451,9396,55,106,788,3
1,Liraglutid 1.8 mg,2018-02-10 12:00:00,5468,5400,68,101,420,3
1,Liraglutid 1.8 mg,2018-02-10 13:00:00,9139,9072,67,81,436,3
1,Liraglutid 1.8 mg,2018-02-10 14:00:00,7093,7020,73,85,518,3
1,Liraglutid 1.8 mg,2018-02-10 15:00:00,7231,7074,157,132,588,3
1,Liraglutid 1.8 mg,2018-02-10 16:00:00,8603,8586,17,151,636,3
1,Liraglutid 1.8 mg,2018-02-10 17:00:00,7764,7722,42,81,2852,3
1,Liraglutid 1.8 mg,2018-02-10 18:00:00,7150,7074,76,79,194,3
1,Liraglutid 1.8 mg,2018-02-10 19:00:00,8472,8370,102,121,488,3
1,Liraglutid 1.8 mg,2018-02-10 20:00:00,7562,7344,218,139,402,3
1,Liraglutid 1.8 mg,2018-02-10 21:00:00,8864,8748,116,127,654,3
1,Liraglutid 1.8 mg,2018-02-10 22:00:00,8016,7938,78,122,494,3
1,Liraglutid 1.8 mg,2018-02-10 23:00:00,9620,9558,62,79,344,3
1,Liraglutid 1.8 mg,2018-02-11 00:00:00,8695,8640,55,118,360,3
1,Liraglutid 1.8 mg,2018-02-11 01:00:00,9404,9342,62,61,460,3
1,Liraglutid 1.8 mg,2018-02-11 02:00:00,9224,9180,44,49,246,3
1,Liraglutid 1.8 mg,2018-02-11 03:00:00,9235,9180,55,50,386,3
1,Liraglutid 1.8 mg,2018-02-11 04:00:00,9414,9342,72,54,288,3
1,Liraglutid 1.8 mg,2018-02-11 05:00:00,9368,9342,26,59,600,3
1,Liraglutid 1.8 mg,2018-02-11 06:00:00,9292,9234,58,61,538,3
1,Liraglutid 1.8 mg,2018-02-11 07:00:00,9399,9342,57,57,350,3
1,Liraglutid 1.8 mg,2018-02-11 08:00:00,9316,9288,28,70,260,3
1,Liraglutid 1.8 mg,2018-02-11 09:00:00,9692,9612,80,88,530,3
1,Liraglutid 1.8 mg,2018-02-11 10:00:00,9536,9504,32,65,438,3
1,Liraglutid 1.8 mg,2018-02-11 11:00:00,7756,7722,34,79,740,3
1,Liraglutid 1.8 mg,2018-02-11 12:00:00,8600,8586,14,38,1886,3
1,Liraglutid 1.8 mg,2018-02-11 13:00:00,9152,9072,80,76,452,3
1,Liraglutid 1.8 mg,2018-02-11 14:00:00,7704,7722,-18,58,396,3
1,Liraglutid 1.8 mg,2018-02-11 15:00:00,4562,5022,-460,86,472,3
1,Liraglutid 1.8 mg,2018-02-11 16:00:00,8321,7668,653,70,644,3
1,Liraglutid 1.8 mg,2018-02-11 17:00:00,8947,8910,37,58,3624,3
1,Liraglutid 1.8 mg,2018-02-11 18:00:00,7220,7398,-178,21,146,3
1,Liraglutid 1.8 mg,2018-02-11 19:00:00,9356,9234,122,57,550,3
1,Liraglutid 1.8 mg,2018-02-11 20:00:00,10000,9990,10,67,402,3
1,Liraglutid 1.8 mg,2018-02-11 21:00:00,8841,8748,93,143,810,3
1,Liraglutid 1.8 mg,2018-02-11 22:00:00,9219,9234,-15,86,512,3
1,Liraglutid 1.8 mg,2018-02-11 23:00:00,8688,8532,156,62,522,3
1,Liraglutid 1.8 mg,2018-02-12 00:00:00,7609,7290,319,81,402,3
1,Liraglutid 1.8 mg,2018-02-12 01:00:00,8584,8532,52,81,210,3
1,Liraglutid 1.8 mg,2018-02-12 02:00:00,8988,8964,24,73,824,3
1,Liraglutid 1.8 mg,2018-02-12 03:00:00,8627,8640,-13,51,868,3
1,Liraglutid 1.8 mg,2018-02-12 04:00:00,9513,9342,171,115,508,3
1,Liraglutid 1.8 mg,2018-02-12 05:00:00,7608,7614,-6,6,3108,3
1,Liraglutid 1.8 mg,2018-02-12 06:00:00,8600,8532,68,44,6304,3
1,Liraglutid 1.8 mg,2018-02-12 07:00:00,20,0,20,1,13200,3
1,Liraglutid 1.8 mg,2018-02-12 08:00:00,244,270,-26,44,150,3
1,Liraglutid 1.8 mg,2018-02-12 09:00:00,4724,4878,-154,4,168,3
1,Liraglutid 1.8 mg,2018-02-12 11:00:00,12,0,12,57,340,3
1,Liraglutid 1.8 mg,2018-02-12 12:00:00,505,486,19,62,576,3
1,Liraglutid 1.8 mg,2018-02-12 13:00:00,224,216,8,71,1124,3
1,Liraglutid 1.8 mg,2018-02-12 14:00:00,2508,2322,186,71,334,3
1,Liraglutid 1.8 mg,2018-02-12 15:00:00,9040,8964,76,88,758,3
1,Liraglutid 1.8 mg,2018-02-12 16:00:00,8340,8262,78,76,534,3
1,Liraglutid 1.8 mg,2018-02-12 17:00:00,7365,7020,345,95,330,3
1,Liraglutid 1.8 mg,2018-02-12 18:00:00,9832,9774,58,115,508,3
1,Liraglutid 1.8 mg,2018-02-12 19:00:00,9036,9018,18,92,1186,3
1,Liraglutid 1.8 mg,2018-02-12 20:00:00,8794,8748,46,43,2056,3
1,Liraglutid 1.8 mg,2018-02-12 21:00:00,10000,9936,64,81,1208,3
1,Liraglutid 1.8 mg,2018-02-12 22:00:00,9072,9126,-54,91,546,3
1,Liraglutid 1.8 mg,2018-02-12 23:00:00,6920,6804,116,63,2778,3
1,Liraglutid 1.8 mg,2018-02-13 00:00:00,4340,4320,20,37,674,3
1,Liraglutid 1.8 mg,2018-02-13 01:00:00,7152,7074,78,43,584,3
1,Liraglutid 1.8 mg,2018-02-13 02:00:00,8959,8910,49,2,3282,3
1,Liraglutid 1.8 mg,2018-02-13 03:00:00,6036,5994,42,32,852,3
1,Liraglutid 1.8 mg,2018-02-13 04:00:00,4859,4806,53,54,442,3
1,Liraglutid 1.8 mg,2018-02-13 05:00:00,9054,9180,-126,44,220,3
1,Liraglutid 1.8 mg,2018-02-13 06:00:00,6720,6480,240,27,450,3
1,Liraglutid 1.8 mg,2018-02-13 07:00:00,9476,9342,134,49,362,3
1,Liraglutid 1.8 mg,2018-02-13 08:00:00,7924,7992,-68,78,352,3
1,Liraglutid 1.8 mg,2018-02-13 09:00:00,178,666,-488,50,272,3
1,Liraglutid 1.8 mg,2018-02-13 10:00:00,8185,7560,625,59,570,3
1,Liraglutid 1.8 mg,2018-02-13 11:00:00,8616,8532,84,33,3244,3
1,Liraglutid 1.8 mg,2018-02-13 12:00:00,10044,9990,54,50,210,3
1,Liraglutid 1.8 mg,2018-02-13 13:00:00,8264,8262,2,32,416,3
1,Liraglutid 1.8 mg,2018-02-13 14:00:00,9700,9666,34,38,366,3
1,Liraglutid 1.8 mg,2018-02-13 15:00:00,9459,9288,171,19,818,3
1,Liraglutid 1.8 mg,2018-02-13 16:00:00,9707,9666,41,44,538,3
1,Liraglutid 1.8 mg,2018-02-13 17:00:00,6518,6534,-16,36,404,3
1,Liraglutid 1.8 mg,2018-02-13 18:00:00,8042,7992,50,26,292,3
1,Liraglutid 1.8 mg,2018-02-13 19:00:00,8479,8316,163,25,448,3
1,Liraglutid 1.8 mg,2018-02-13 20:00:00,9856,9882,-26,26,270,3
1,Liraglutid 1.8 mg,2018-02-13 21:00:00,10019,9882,137,34,308,3
1,Liraglutid 1.8 mg,2018-02-13 22:00:00,8501,8460,41,72,496,3
1,Liraglutid 1.8 mg,2018-02-13 23:00:00,8520,8532,-12,23,2880,3
1,Liraglutid 1.8 mg,2018-02-14 00:00:00,9914,9774,140,45,356,3
1,Liraglutid 1.8 mg,2018-02-14 01:00:00,7552,7470,82,46,808,3
1,Liraglutid 1.8 mg,2018-02-14 02:00:00,9884,9828,56,45,310,3
1,Liraglutid 1.8 mg,2018-02-14 03:00:00,8500,8424,76,19,142,3
1,Liraglutid 1.8 mg,2018-02-14 04:00:00,8022,7992,30,39,792,3
1,Liraglutid 1.8 mg,2018-02-14 05:00:00,9400,9234,166,61,700,3
1,Liraglutid 1.8 mg,2018-02-14 06:00:00,68,216,-148,52,832,3
1,Liraglutid 1.8 mg,2018-02-14 08:00:00,3579,3564,15,41,322,3.5
1,Liraglutid 1.8 mg,2018-02-14 09:00:00,10308,10152,156,36,2240,4
1,Liraglutid 1.8 mg,2018-02-14 10:00:00,8491,8370,121,51,306,4
1,Liraglutid 1.8 mg,2018-02-14 11:00:00,9272,9234,38,28,1396,4
1,Liraglutid 1.8 mg,2018-02-14 12:00:00,9106,9126,-20,53,282,4
1,Liraglutid 1.8 mg,2018-02-14 13:00:00,8451,8316,135,28,2360,4
1,Liraglutid 1.8 mg,2018-02-14 14:00:00,9336,9288,48,49,348,4
1,Liraglutid 1.8 mg,2018-02-14 15:00:00,8808,8748,60,29,1118,4
1,Liraglutid 1.8 mg,2018-02-14 16:00:00,9690,9504,186,42,226,4
1,Liraglutid 1.8 mg,2018-02-14 17:00:00,9816,9774,42,34,9272,4
1,Liraglutid 1.8 mg,2018-02-14 18:00:00,9564,9558,6,67,428,4
1,Liraglutid 1.8 mg,2018-02-14 19:00:00,7508,7452,56,41,810,4
1,Liraglutid 1.8 mg,2018-02-14 20:00:00,10268,10152,116,52,530,4
1,Liraglutid 1.8 mg,2018-02-14 21:00:00,2666,3168,-502,80,1554,3.5
1,NovoMix 30 GLY (CCH),2018-02-15 00:00:00,2489,1836,653,40,196,3.5
1,NovoMix 30 GLY (CCH),2018-02-15 01:00:00,9044,8964,80,24,1914,3.5
1,NovoMix 30 GLY (CCH),2018-02-15 02:00:00,9147,8910,237,58,2142,3.5
1,NovoMix 30 GLY (CCH),2018-02-15 03:00:00,3407,3402,5,74,682,3.5
1,NovoMix 30 GLY (CCH),2018-02-15 04:00:00,6848,6696,152,25,3148,3.5
1,NovoMix 30 GLY (CCH),2018-02-15 05:00:00,7372,7344,28,68,578,3.5
1,NovoMix 30 GLY (CCH),2018-02-15 06:00:00,7996,7776,220,78,596,3.5
1,NovoMix 30 GLY (CCH),2018-02-15 07:00:00,7807,7668,139,59,604,3.5
1,NovoMix 30 GLY (CCH),2018-02-15 08:00:00,8092,8100,-8,58,2092,3.5
1,NovoMix 30 GLY (CCH),2018-02-15 09:00:00,7991,7722,269,54,250,3.5
1,NovoMix 30 GLY (CCH),2018-02-15 10:00:00,6444,6876,-432,29,268,3.5
1,Liraglutid 1.8 mg,2018-02-15 13:00:00,8899,8532,367,84,404,3.5
1,Liraglutid 1.8 mg,2018-02-15 14:00:00,10448,10422,26,68,370,3.5
1,Liraglutid 1.8 mg,2018-02-15 15:00:00,8280,8208,72,66,296,3.5
1,Liraglutid 1.8 mg,2018-02-15 16:00:00,9564,9504,60,87,252,3.5
1,Liraglutid 1.8 mg,2018-02-15 17:00:00,10644,10584,60,41,248,3.5
1,Liraglutid 1.8 mg,2018-02-15 18:00:00,9728,9720,8,38,276,3.5
1,Liraglutid 1.8 mg,2018-02-15 19:00:00,8526,8478,48,37,640,3.5
1,Liraglutid 1.8 mg,2018-02-15 20:00:00,8928,8856,72,41,592,3.5
1,Liraglutid 1.8 mg,2018-02-15 21:00:00,9643,9504,139,29,2590,3.5
1,Liraglutid 1.8 mg,2018-02-15 22:00:00,9516,9540,-24,44,620,3.5
1,Liraglutid 1.8 mg,2018-02-15 23:00:00,10416,10314,102,82,3870,3.5
1,Liraglutid 1.8 mg,2018-02-16 00:00:00,10172,10134,38,15,138,3.5
1,Liraglutid 1.8 mg,2018-02-16 01:00:00,9926,9990,-64,88,458,3.5
1,Liraglutid 1.8 mg,2018-02-16 02:00:00,9952,9774,178,91,1534,3.5
1,Liraglutid 1.8 mg,2018-02-16 03:00:00,10028,9990,38,104,354,3.5
1,Liraglutid 1.8 mg,2018-02-16 04:00:00,10035,9936,99,102,380,3.5
1,Liraglutid 1.8 mg,2018-02-16 05:00:00,9628,9558,70,5,226,3.5
1,Liraglutid 1.8 mg,2018-02-16 06:00:00,10184,10098,86,62,1376,3.5
1,Liraglutid 1.8 mg,2018-02-16 07:00:00,5356,5400,-44,38,1200,3.5
1,Liraglutid 1.8 mg,2018-02-16 09:00:00,16,108,-92,107,904,3.5
1,Liraglutid 1.8 mg,2018-02-16 10:00:00,6136,5886,250,137,442,3.5
1,Liraglutid 1.8 mg,2018-02-16 11:00:00,7352,7236,116,128,474,3.5
1,Liraglutid 1.8 mg,2018-02-16 12:00:00,9628,9612,16,121,326,3.5
1,Liraglutid 1.8 mg,2018-02-16 13:00:00,8875,8694,181,74,336,3.5
1,Liraglutid 1.8 mg,2018-02-16 14:00:00,9445,9342,103,58,268,3.5
1,Liraglutid 1.8 mg,2018-02-16 15:00:00,9264,9180,84,94,214,3.5
1,Liraglutid 1.8 mg,2018-02-16 16:00:00,9586,9504,82,133,366,3.5
1,Liraglutid 1.8 mg,2018-02-16 17:00:00,8762,8964,-202,112,556,3.5
1,Liraglutid 1.8 mg,2018-02-16 18:00:00,10088,9774,314,90,598,3.5
1,Liraglutid 1.8 mg,2018-02-16 19:00:00,9735,9774,-39,128,634,3.5
1,Liraglutid 1.8 mg,2018-02-16 20:00:00,9792,9666,126,159,526,3.5
1,Liraglutid 1.8 mg,2018-02-16 21:00:00,4065,4104,-39,117,792,3.5
1,Liraglutid 1.8 mg,2018-02-16 22:00:00,6431,6372,59,164,688,3
1,Liraglutid 1.8 mg,2018-02-16 23:00:00,2006,1890,116,133,1552,2.33333333333333
1,Liraglutid 1.8 mg,2018-02-16 23:00:00,2006,1890,116,133,1552,2.33333333333333
1,Liraglutid 1.8 mg,2018-02-17 00:00:00,9260,9180,80,154,636,2
1,Liraglutid 1.8 mg,2018-02-17 01:00:00,9143,9072,71,140,962,2
1,Liraglutid 1.8 mg,2018-02-17 02:00:00,9948,9990,-42,172,636,2
1,Liraglutid 1.8 mg,2018-02-17 03:00:00,8830,8748,82,114,2882,2
1,Liraglutid 1.8 mg,2018-02-17 04:00:00,9312,9180,132,43,208,2
1,Liraglutid 1.8 mg,2018-02-17 05:00:00,8912,8910,2,105,2242,2
1,Liraglutid 1.8 mg,2018-02-17 06:00:00,8264,8262,2,60,124,2
1,Liraglutid 1.8 mg,2018-02-17 07:00:00,5072,5076,-4,77,1888,2
1,Liraglutid 1.8 mg,2018-02-17 08:00:00,8724,8586,138,129,684,2
1,Liraglutid 1.8 mg,2018-02-17 09:00:00,5784,5886,-102,125,560,2
1,Liraglutid 1.8 mg,2018-02-17 10:00:00,7996,7668,328,153,532,2
1,Liraglutid 1.8 mg,2018-02-17 11:00:00,7596,7614,-18,124,1048,2
1,Liraglutid 1.8 mg,2018-02-17 12:00:00,9222,9018,204,99,656,2
1,Liraglutid 1.8 mg,2018-02-17 13:00:00,9656,9666,-10,113,820,2
1,Liraglutid 1.8 mg,2018-02-17 14:00:00,9600,9504,96,138,706,2
1,Liraglutid 1.8 mg,2018-02-17 15:00:00,9524,9396,128,104,562,2.4
1,Liraglutid 1.8 mg,2018-02-17 16:00:00,9348,9378,-30,78,868,4
1,Liraglutid 1.8 mg,2018-02-17 17:00:00,8656,8532,124,127,416,4
1,Liraglutid 1.8 mg,2018-02-17 18:00:00,9572,9504,68,101,810,4
1,Liraglutid 1.8 mg,2018-02-17 19:00:00,8588,8478,110,69,748,4
1,Liraglutid 1.8 mg,2018-02-17 20:00:00,9588,9558,30,111,638,4
1,Liraglutid 1.8 mg,2018-02-17 21:00:00,8440,8370,70,113,564,4
1,Liraglutid 1.8 mg,2018-02-17 22:00:00,9060,8964,96,133,390,4
1,Liraglutid 1.8 mg,2018-02-17 23:00:00,10348,10260,88,116,572,3
1,Liraglutid 1.8 mg,2018-02-18 00:00:00,10244,10152,92,7,3402,2.5
1,Liraglutid 1.8 mg,2018-02-18 01:00:00,9656,9612,44,123,1006,2.5
1,Liraglutid 1.8 mg,2018-02-18 02:00:00,10128,10098,30,143,822,2.5
1,Liraglutid 1.8 mg,2018-02-18 03:00:00,8200,8100,100,145,612,2.5
1,Liraglutid 1.8 mg,2018-02-18 04:00:00,10416,10314,102,119,688,2.5
1,Liraglutid 1.8 mg,2018-02-18 05:00:00,8523,8424,99,129,490,2.5
1,Liraglutid 1.8 mg,2018-02-18 06:00:00,10368,10314,54,192,500,2.5
1,Liraglutid 1.8 mg,2018-02-18 07:00:00,9956,9882,74,145,512,2.5
1,Liraglutid 1.8 mg,2018-02-18 08:00:00,5730,6210,-480,138,602,2.5
1,Detemir Gly (CCH),2018-02-18 10:00:00,7828,3888,3940,70,350,2.5
1,Detemir Gly (CCH),2018-02-18 11:00:00,9920,9774,146,48,868,2.5
1,Detemir Gly (CCH),2018-02-18 12:00:00,10440,10260,180,40,676,2.5
1,Detemir Gly (CCH),2018-02-18 13:00:00,9964,9882,82,66,410,2.5
1,Detemir Gly (CCH),2018-02-18 14:00:00,8751,8910,-159,56,668,2.4
1,Detemir Gly (CCH),2018-02-18 15:00:00,8628,8316,312,68,374,2
1,Detemir Gly (CCH),2018-02-18 16:00:00,9724,9666,58,80,412,3
1,Detemir Gly (CCH),2018-02-18 17:00:00,8952,8910,42,43,904,3
1,Detemir Gly (CCH),2018-02-18 18:00:00,9660,9504,156,60,484,3
1,Detemir Gly (CCH),2018-02-18 19:00:00,9040,9072,-32,54,542,3.5
1,Detemir Gly (CCH),2018-02-18 20:00:00,7830,7668,162,53,380,3.5
1,Detemir Gly (CCH),2018-02-18 21:00:00,9028,9126,-98,70,232,3.5
1,Detemir Gly (CCH),2018-02-18 22:00:00,9467,9234,233,67,472,3.5
1,Detemir Gly (CCH),2018-02-18 23:00:00,9932,9828,104,69,266,3.5
1,Detemir Gly (CCH),2018-02-19 00:00:00,10088,10044,44,65,266,3.5
1,Detemir Gly (CCH),2018-02-19 01:00:00,9596,9558,38,67,534,3.5
1,Detemir Gly (CCH),2018-02-19 02:00:00,10112,10044,68,88,300,3.5
1,Detemir Gly (CCH),2018-02-19 03:00:00,10224,10098,126,67,232,3.5
1,Detemir Gly (CCH),2018-02-19 04:00:00,8672,8640,32,81,322,3.5
1,Detemir Gly (CCH),2018-02-19 05:00:00,9600,9504,96,80,380,3
1,Detemir Gly (CCH),2018-02-19 06:00:00,10219,10152,67,40,538,2.33333333333333
1,Detemir Gly (CCH),2018-02-19 07:00:00,9976,9936,40,188,1664,2
1,Detemir Gly (CCH),2018-02-19 08:00:00,9827,9774,53,153,1820,2
1,Detemir Gly (CCH),2018-02-19 09:00:00,10332,10206,126,37,3398,2
1,Detemir Gly (CCH),2018-02-19 10:00:00,9280,9342,-62,23,224,2
1,Detemir Gly (CCH),2018-02-19 11:00:00,7760,7614,146,45,5206,2
1,Detemir Gly (CCH),2018-02-19 12:00:00,9752,9720,32,9,122,2
1,Detemir Gly (CCH),2018-02-19 13:00:00,2251,2214,37,60,554,2
1,Detemir Gly (CCH),2018-02-19 14:00:00,9044,9018,26,35,770,2
1,Detemir Gly (CCH),2018-02-19 15:00:00,3172,3672,-500,56,914,2
1,Detemir Gly (CCH),2018-02-19 16:00:00,2506,2052,454,51,600,2
1,Detemir Gly (CCH),2018-02-19 17:00:00,9360,9126,234,39,3274,2
1,Detemir Gly (CCH),2018-02-19 18:00:00,8396,8208,188,6,1312,2
1,Detemir Gly (CCH),2018-02-19 19:00:00,8008,7992,16,36,2194,2
1,Detemir Gly (CCH),2018-02-19 20:00:00,7515,7560,-45,28,2290,2
1,Detemir Gly (CCH),2018-02-19 21:00:00,6353,6498,-145,15,3152,2.66666666666667
1,FLEX.LIRA 6MG 8.15 LI.BLUE CAP,2018-02-19 22:00:00,1334,756,578,11,3112,4
1,FLEX.LIRA 6MG 8.15 LI.BLUE CAP,2018-02-19 23:00:00,4008,3780,228,25,1158,4
1,FLEX.LIRA 6MG 8.15 LI.BLUE CAP,2018-02-20 00:00:00,3708,3780,-72,43,1140,4
1,FLEX.LIRA 6MG 8.15 LI.BLUE CAP,2018-02-20 01:00:00,1263,1152,111,40,3608,4
1,Actrapid,2018-02-20 01:00:00,1263,1152,111,40,3608,4
1,Actrapid,2018-02-20 02:00:00,2576,2376,200,35,350,4
1,Actrapid,2018-02-20 03:00:00,5728,5508,220,82,378,4
1,Actrapid,2018-02-20 04:00:00,7480,7074,406,118,502,4
1,Actrapid,2018-02-20 05:00:00,3174,3582,-408,71,664,4
1,NovoMix 50 NN2000,2018-02-20 06:00:00,6330,5778,552,62,772,4
1,NovoMix 50 NN2000,2018-02-20 07:00:00,9744,9612,132,62,256,4
1,NovoMix 50 NN2000,2018-02-20 08:00:00,9544,9396,148,110,520,4
1,NovoMix 50 NN2000,2018-02-20 09:00:00,8600,8532,68,69,428,4
1,NovoMix 50 NN2000,2018-02-20 10:00:00,6127,5994,133,29,3286,4
1,NovoMix 50 NN2000,2018-02-20 11:00:00,10212,10152,60,20,1096,4
1,NovoMix 50 NN2000,2018-02-20 12:00:00,9032,8964,68,36,2830,4
1,NovoMix 50 NN2000,2018-02-20 13:00:00,8876,8802,74,10,4266,3.5
1,NovoMix 50 NN2000,2018-02-20 14:00:00,4374,4788,-414,16,1518,3
1,Liraglutid lysBlKapsel (placebo),2018-02-20 15:00:00,4185,3618,567,49,1564,3
1,Liraglutid lysBlKapsel (placebo),2018-02-20 16:00:00,2691,2592,99,25,576,3
1,Liraglutid lysBlKapsel (placebo),2018-02-20 17:00:00,0,306,-306,79,588,3
1,Liraglutid,2018-02-20 18:00:00,3054,2430,624,19,5158,3
1,Liraglutid,2018-02-20 19:00:00,7573,7398,175,18,200,3.5
1,Liraglutid,2018-02-20 20:00:00,6028,5994,34,42,512,4
1,Liraglutid,2018-02-20 21:00:00,8167,7884,283,61,616,4
1,Liraglutid,2018-02-20 22:00:00,1655,2196,-541,67,346,4
1,NovoMix 50 NN2000,2018-02-20 23:00:00,3326,2754,572,57,424,4
1,NovoMix 50 NN2000,2018-02-21 00:00:00,9348,9126,222,55,628,4
1,NovoMix 50 NN2000,2018-02-21 01:00:00,8976,8964,12,56,442,4
1,NovoMix 50 NN2000,2018-02-21 02:00:00,10076,9936,140,95,668,4
1,NovoMix 50 NN2000,2018-02-21 03:00:00,9566,9396,170,55,2600,4
1,NovoMix 50 NN2000,2018-02-21 04:00:00,8843,8856,-13,149,592,4
1,NovoMix 50 NN2000,2018-02-21 05:00:00,9740,9504,236,59,648,4
1,NovoMix 50 NN2000,2018-02-21 06:00:00,8911,8802,109,86,484,4
1,NovoMix 50 NN2000,2018-02-21 07:00:00,2848,2934,-86,2,1632,4
1,NovoMix 50 NN2000,2018-02-21 07:00:00,2848,2934,-86,2,1632,4
1,NovoMix 50 NN2000,2018-02-21 08:00:00,9080,8802,278,85,1006,4
1,NovoMix 50 NN2000,2018-02-21 09:00:00,8196,8154,42,23,800,4
1,NovoMix 50 NN2000,2018-02-21 10:00:00,9332,9180,152,2,4122,4
1,NovoMix 50 NN2000,2018-02-21 11:00:00,7872,7830,42,57,952,4
1,NovoMix 50 NN2000,2018-02-21 12:00:00,9792,9666,126,103,492,4
1,NovoMix 50 NN2000,2018-02-21 13:00:00,9512,9396,116,34,3902,4
1,NovoMix 50 NN2000,2018-02-21 14:00:00,9224,9288,-64,109,596,4
1,NovoMix 50 NN2000,2018-02-21 15:00:00,7554,7884,-330,126,386,4
1,Liraglutid 1.8 mg,2018-02-21 17:00:00,7656,7074,582,140,596,4
1,Liraglutid 1.8 mg,2018-02-21 18:00:00,9132,9072,60,130,702,4
1,Liraglutid 1.8 mg,2018-02-21 19:00:00,9576,9578,-2,119,336,4
1,Liraglutid 1.8 mg,2018-02-21 20:00:00,9608,9504,104,190,536,4
1,Liraglutid 1.8 mg,2018-02-21 21:00:00,8952,8910,42,183,612,4
1,Liraglutid 1.8 mg,2018-02-21 22:00:00,8788,8748,40,198,540,4
1,Liraglutid 1.8 mg,2018-02-21 23:00:00,9683,9558,125,208,776,4
1,Liraglutid 1.8 mg,2018-02-22 00:00:00,8964,8910,54,188,484,4
1,Liraglutid 1.8 mg,2018-02-22 01:00:00,8908,8856,52,183,668,4
1,Liraglutid 1.8 mg,2018-02-22 02:00:00,8888,8910,-22,188,564,4
1,Liraglutid 1.8 mg,2018-02-22 03:00:00,8222,8154,68,104,306,4
1,Liraglutid 1.8 mg,2018-02-22 04:00:00,8232,8046,186,147,586,4
1,Liraglutid 1.8 mg,2018-02-22 05:00:00,8612,8640,-28,107,1342,4
1,Liraglutid 1.8 mg,2018-02-22 06:00:00,8294,8208,86,40,1828,3.66666666666667
1,Liraglutid 1.8 mg,2018-02-22 07:00:00,9812,9774,38,89,486,3
1,Liraglutid 1.8 mg,2018-02-22 08:00:00,8980,8910,70,135,558,3
1,Liraglutid 1.8 mg,2018-02-22 09:00:00,8068,8046,22,155,1046,3
1,Liraglutid 1.8 mg,2018-02-22 10:00:00,3988,3996,-8,173,606,3
1,Liraglutid 1.8 mg,2018-02-22 11:00:00,9592,9504,88,138,828,3
1,Liraglutid 1.8 mg,2018-02-22 12:00:00,8876,8856,20,165,540,3
1,Liraglutid 1.8 mg,2018-02-22 13:00:00,7108,7074,34,152,846,3
1,Liraglutid 1.8 mg,2018-02-22 14:00:00,8968,8910,58,142,418,3
1,Liraglutid 1.8 mg,2018-02-22 15:00:00,8119,8046,73,136,756,3
1,Liraglutid 1.8 mg,2018-02-22 16:00:00,9148,9126,22,161,696,3
1,Liraglutid 1.8 mg,2018-02-22 17:00:00,8420,8316,104,172,888,3
1,Liraglutid 1.8 mg,2018-02-22 18:00:00,9400,9396,4,151,992,3
1,Liraglutid 1.8 mg,2018-02-22 19:00:00,7976,7938,38,119,1292,3
1,Liraglutid 1.8 mg,2018-02-22 20:00:00,8224,8154,70,149,768,3
1,Liraglutid 1.8 mg,2018-02-22 21:00:00,8056,8100,-44,179,610,3
1,Liraglutid 1.8 mg,2018-02-22 22:00:00,7863,7722,141,172,554,3
1,Liraglutid 1.8 mg,2018-02-22 23:00:00,6460,6426,34,117,5188,3
1,Liraglutid 1.8 mg,2018-02-23 00:00:00,8232,8154,78,11,1610,3
1,Liraglutid 1.8 mg,2018-02-23 01:00:00,8818,8802,16,39,1066,3
1,Liraglutid 1.8 mg,2018-02-23 02:00:00,8860,8802,58,62,3668,3
1,Liraglutid 1.8 mg,2018-02-23 03:00:00,4326,4860,-534,49,1128,3
1,Detemir Gly (CCH),2018-02-23 04:00:00,1014,432,582,5,4598,3
1,Detemir Gly (CCH),2018-02-23 05:00:00,2232,2268,-36,56,5114,3
1,Detemir Gly (CCH),2018-02-23 06:00:00,4572,4266,306,23,3012,3
1,Detemir Gly (CCH),2018-02-23 07:00:00,1772,1782,-10,25,152,3
1,Detemir Gly (CCH),2018-02-23 08:00:00,158,576,-418,32,384,3
1,NovoMix 30 GLY (CCH),2018-02-23 09:00:00,5226,4644,582,80,368,3
1,NovoMix 30 GLY (CCH),2018-02-23 11:00:00,2616,2538,78,158,768,3
1,NovoMix 30 GLY (CCH),2018-02-23 12:00:00,2036,1998,38,176,644,3
1,NovoMix 30 GLY (CCH),2018-02-23 13:00:00,2812,2808,4,147,734,3
1,NovoMix 30 GLY (CCH),2018-02-23 14:00:00,6468,6372,96,93,1444,3
1,NovoMix 30 GLY (CCH),2018-02-23 15:00:00,8696,8802,-106,98,396,3
1,NovoMix 30 GLY (CCH),2018-02-23 16:00:00,8476,8262,214,119,1086,3
1,NovoMix 30 GLY (CCH),2018-02-23 17:00:00,8500,8478,22,87,496,3
1,NovoMix 30 GLY (CCH),2018-02-23 18:00:00,6432,6372,60,84,430,3
1,NovoMix 30 GLY (CCH),2018-02-23 19:00:00,9656,9720,-64,120,660,3
1,NovoMix 30 GLY (CCH),2018-02-23 20:00:00,8824,8586,238,57,4212,3
1,NovoMix 30 GLY (CCH),2018-02-23 21:00:00,8052,7956,96,69,196,3
1,NovoMix 30 GLY (CCH),2018-02-23 22:00:00,9688,9612,76,171,472,3
1,NovoMix 30 GLY (CCH),2018-02-23 23:00:00,8843,8748,95,172,934,3
1,NovoMix 30 GLY (CCH),2018-02-24 00:00:00,2957,3474,-517,147,456,3
1,Liraglutid 1.8 mg,2018-02-24 01:00:00,4826,4158,668,1,22856,3
1,Liraglutid 1.8 mg,2018-02-24 02:00:00,9048,8964,84,154,606,3
1,Liraglutid 1.8 mg,2018-02-24 03:00:00,7068,6966,102,146,1042,3
1,Liraglutid 1.8 mg,2018-02-24 04:00:00,8020,8046,-26,87,2560,3
1,Liraglutid 1.8 mg,2018-02-24 05:00:00,8312,8100,212,101,386,3
1,Liraglutid 1.8 mg,2018-02-24 06:00:00,7308,7290,18,127,944,3
1,Liraglutid 1.8 mg,2018-02-24 07:00:00,6093,5940,153,7,438,3
1,Liraglutid 1.8 mg,2018-02-24 08:00:00,8928,8856,72,176,560,3
1,Liraglutid 1.8 mg,2018-02-24 09:00:00,7024,6912,112,29,4276,3
1,Liraglutid 1.8 mg,2018-02-24 10:00:00,4494,4932,-438,160,534,3
1,Liraglutid 1.8 mg,2018-02-24 11:00:00,6388,5778,610,13,1162,3
1,Liraglutid 1.8 mg,2018-02-24 12:00:00,6904,6804,100,19,27600,3
1,Liraglutid 1.8 mg,2018-02-24 13:00:00,8784,8748,36,23,208,3
1,Liraglutid 1.8 mg,2018-02-24 14:00:00,9132,9126,6,34,600,3
1,Liraglutid 1.8 mg,2018-02-24 15:00:00,672,1080,-408,34,186,3
1,Liraglutid 1.8 mg,2018-02-24 22:00:00,1452,1026,426,158,448,3
1,Liraglutid 1.8 mg,2018-02-24 23:00:00,6727,6642,85,142,490,3
1,Liraglutid 1.8 mg,2018-02-25 00:00:00,8360,8262,98,159,432,3
1,Liraglutid 1.8 mg,2018-02-25 01:00:00,9172,9126,46,139,476,3
1,Liraglutid 1.8 mg,2018-02-25 02:00:00,8816,8748,68,152,358,3
1,Liraglutid 1.8 mg,2018-02-25 03:00:00,9380,9342,38,140,670,3
1,Liraglutid 1.8 mg,2018-02-25 04:00:00,9340,9288,52,139,428,3
1,Liraglutid 1.8 mg,2018-02-25 05:00:00,9588,9558,30,118,452,3
1,Liraglutid 1.8 mg,2018-02-25 06:00:00,8832,8802,30,149,544,3
1,Liraglutid 1.8 mg,2018-02-25 07:00:00,9380,9288,92,160,482,3
1,Liraglutid 1.8 mg,2018-02-25 08:00:00,9440,9396,44,142,2524,3
1,Liraglutid 1.8 mg,2018-02-25 09:00:00,9200,9126,74,21,3114,3
1,Liraglutid 1.8 mg,2018-02-25 10:00:00,9240,9288,-48,29,1404,3
1,Liraglutid 1.8 mg,2018-02-25 11:00:00,6544,6642,-98,89,604,3
1,Liraglutid 1.8 mg,2018-02-25 12:00:00,916,864,52,73,728,3
1,Liraglutid 1.8 mg,2018-02-25 13:00:00,4004,3942,62,125,620,3
1,Liraglutid 1.8 mg,2018-02-25 14:00:00,8443,8262,181,116,980,3
1,Liraglutid 1.8 mg,2018-02-25 15:00:00,7014,6912,102,84,1208,3
1,Liraglutid 1.8 mg,2018-02-25 16:00:00,8547,8640,-93,118,974,3
1,Liraglutid 1.8 mg,2018-02-25 17:00:00,7232,7074,158,119,954,3
1,Liraglutid 1.8 mg,2018-02-25 18:00:00,7252,7236,16,106,902,3
1,Liraglutid 1.8 mg,2018-02-25 19:00:00,7920,7830,90,137,720,3
1,Liraglutid 1.8 mg,2018-02-25 20:00:00,7388,7398,-10,141,476,3
1,Liraglutid 1.8 mg,2018-02-25 21:00:00,7816,7722,94,155,586,3
1,Liraglutid 1.8 mg,2018-02-25 22:00:00,8101,7992,109,210,740,3
1,Liraglutid 1.8 mg,2018-02-25 23:00:00,9212,9180,32,161,424,3
1,Liraglutid 1.8 mg,2018-02-26 00:00:00,9008,8964,44,165,500,3
1,Liraglutid 1.8 mg,2018-02-26 01:00:00,8455,8370,85,166,484,3
1,Liraglutid 1.8 mg,2018-02-26 02:00:00,9544,9558,-14,156,2614,3
1,Liraglutid 1.8 mg,2018-02-26 03:00:00,9148,9288,-140,3,2716,3
1,Liraglutid 1.8 mg,2018-02-26 04:00:00,9268,9018,250,13,1756,3
1,Liraglutid 1.8 mg,2018-02-26 05:00:00,7434,7956,-522,101,842,3
1,Liraglutid 0.9 mg,2018-02-26 07:00:00,678,162,516,102,630,3
1,Liraglutid 0.9 mg,2018-02-26 08:00:00,7387,7236,151,41,324,3
1,Liraglutid 0.9 mg,2018-02-26 09:00:00,8635,8532,103,39,754,3
1,Liraglutid 0.9 mg,2018-02-26 10:00:00,7272,7236,36,29,1186,3
1,Liraglutid 0.9 mg,2018-02-26 11:00:00,8987,8964,23,26,206,3
1,Liraglutid 0.9 mg,2018-02-26 12:00:00,7176,7074,102,33,866,3
1,Liraglutid 0.9 mg,2018-02-26 13:00:00,7580,7506,74,23,238,3
1,Liraglutid 0.9 mg,2018-02-26 14:00:00,9592,9504,88,63,370,3
1,Liraglutid 0.9 mg,2018-02-26 15:00:00,9796,9774,22,56,558,3
1,Liraglutid 0.9 mg,2018-02-26 16:00:00,9572,9504,68,74,538,3
1,Liraglutid 0.9 mg,2018-02-26 17:00:00,9568,9504,64,85,3170,3
1,Liraglutid 0.9 mg,2018-02-26 18:00:00,8784,8748,36,38,588,3
1,Liraglutid 0.9 mg,2018-02-26 19:00:00,8762,8640,122,27,200,3
1,Liraglutid 0.9 mg,2018-02-26 20:00:00,9467,9450,17,36,480,3
1,Liraglutid 0.9 mg,2018-02-26 21:00:00,9092,9126,-34,36,260,3
1,Liraglutid 0.9 mg,2018-02-26 22:00:00,8608,8532,76,37,594,3
1,Liraglutid 0.9 mg,2018-02-26 23:00:00,3130,3564,-434,24,2842,3
1,Liraglutid 1.8 mg,2018-02-27 00:00:00,8778,8154,624,22,334,3.5
1,Liraglutid 1.8 mg,2018-02-27 01:00:00,9172,9126,46,55,382,3.5
1,Liraglutid 1.8 mg,2018-02-27 02:00:00,9420,9450,-30,31,180,3.5
1,Liraglutid 1.8 mg,2018-02-27 03:00:00,8960,8802,158,29,242,3.5
1,Liraglutid 1.8 mg,2018-02-27 04:00:00,9384,9396,-12,49,720,3.5
1,Liraglutid 1.8 mg,2018-02-27 05:00:00,1180,1134,46,49,394,3
1,Liraglutid 1.8 mg,2018-02-27 06:00:00,3052,3186,-134,33,504,3
1,Liraglutid 1.8 mg,2018-02-27 16:00:00,804,702,102,33,324,3
1,Liraglutid 1.8 mg,2018-02-27 17:00:00,8796,8802,-6,30,216,3
1,Liraglutid 1.8 mg,2018-02-27 18:00:00,5048,4968,80,51,956,3
1,Liraglutid 1.8 mg,2018-02-27 19:00:00,6848,6858,-10,61,582,3.5
1,Liraglutid 1.8 mg,2018-02-27 20:00:00,8514,8478,36,39,722,3.5
1,Liraglutid 1.8 mg,2018-02-27 21:00:00,6768,6642,126,29,514,3.5
1,Liraglutid 1.8 mg,2018-02-27 22:00:00,8187,8046,141,35,984,3.5
1,Liraglutid 1.8 mg,2018-02-27 23:00:00,9475,9450,25,35,252,3.5
1,Liraglutid 1.8 mg,2018-02-28 00:00:00,9564,9504,60,36,2636,3.5
1,Liraglutid 1.8 mg,2018-02-28 01:00:00,8620,8586,34,26,238,3.5
1,Liraglutid 1.8 mg,2018-02-28 02:00:00,9336,9288,48,40,846,3.5
1,Liraglutid 1.8 mg,2018-02-28 03:00:00,8780,8748,32,35,224,3.5
1,Liraglutid 1.8 mg,2018-02-28 04:00:00,7596,7506,90,80,542,3.5
1,Liraglutid 1.8 mg,2018-02-28 05:00:00,6752,6696,56,37,516,3.5
1,Liraglutid 1.8 mg,2018-02-28 06:00:00,9284,9234,50,46,426,3.5
1,Liraglutid 1.8 mg,2018-02-28 07:00:00,8156,8100,56,38,2246,3.5
1,Liraglutid 1.8 mg,2018-02-28 08:00:00,9560,9504,56,52,696,3.5
1,Liraglutid 1.8 mg,2018-02-28 09:00:00,9404,9288,116,66,2170,3.5
1,Liraglutid 1.8 mg,2018-02-28 10:00:00,7479,7452,27,35,1490,3.5
1,Liraglutid 1.8 mg,2018-02-28 11:00:00,10164,10044,120,31,742,3.5
1,Liraglutid 1.8 mg,2018-02-28 12:00:00,8816,8802,14,53,548,3.5
1,Liraglutid 1.8 mg,2018-02-28 13:00:00,8144,8046,98,54,480,3.5
1,Liraglutid 1.8 mg,2018-02-28 14:00:00,9912,9882,30,84,352,3.5
1,Liraglutid 1.8 mg,2018-02-28 15:00:00,9464,9342,122,34,298,3.5
1,Liraglutid 1.8 mg,2018-02-28 16:00:00,9148,9234,-86,38,476,3.5
1,Liraglutid 1.8 mg,2018-02-28 17:00:00,9060,8910,150,28,278,3.5
1,Liraglutid 1.8 mg,2018-02-28 18:00:00,8606,8640,-34,27,232,3.5
1,Liraglutid 1.8 mg,2018-02-28 19:00:00,3516,3564,-48,24,670,3.5
1,Liraglutid 1.8 mg,2018-03-01 06:00:00,3068,2808,260,31,822,3.5
1,Liraglutid 1.8 mg,2018-03-01 07:00:00,5257,5400,-143,29,422,3.5
1,Liraglutid 1.8 mg,2018-03-01 08:00:00,0,126,-126,36,794,3.5
1,Liraglutid 1.8 mg,2018-03-01 09:00:00,5814,5292,522,26,250,3.5
1,Liraglutid 1.8 mg,2018-03-01 10:00:00,9707,9504,203,14,490,3.5
1,Liraglutid 1.8 mg,2018-03-01 11:00:00,9620,9612,8,30,644,3.5
1,Liraglutid 1.8 mg,2018-03-01 12:00:00,10071,10044,27,24,434,3.5
1,Liraglutid 1.8 mg,2018-03-01 13:00:00,8324,8190,134,27,236,3.5
1,Liraglutid 1.8 mg,2018-03-01 14:00:00,3930,4428,-498,30,432,3.5
2,FlexPen Aspart 100 3ML CCH,2018-01-02 10:00:00,4474,3996,478,16,260,2.5
2,FlexPen Aspart 100 3ML CCH,2018-01-02 11:00:00,9608,9396,212,29,484,2.5
2,FlexPen Aspart 100 3ML CCH,2018-01-02 12:00:00,10840,10746,94,17,138,2.5
2,FlexPen Aspart 100 3ML CCH,2018-01-02 13:00:00,10076,10098,-22,50,226,2.5
2,FlexPen Aspart 100 3ML CCH,2018-01-02 14:00:00,10007,9990,17,55,344,2.5
2,FlexPen Aspart 100 3ML CCH,2018-01-02 15:00:00,9928,9828,100,42,322,2.5
2,FlexPen Aspart 100 3ML CCH,2018-01-02 16:00:00,10260,10098,162,28,298,2.66666666666667
2,FlexPen Aspart 100 3ML CCH,2018-01-02 17:00:00,11024,10962,62,14,38,2.66666666666667
2,FlexPen Aspart 100 3ML CCH,2018-01-02 18:00:00,9632,9558,74,48,448,2.66666666666667
2,FlexPen Aspart 100 3ML CCH,2018-01-02 19:00:00,10476,10368,108,35,224,2.66666666666667
2,FlexPen Aspart 100 3ML CCH,2018-01-02 20:00:00,10400,10368,32,17,138,2.66666666666667
2,FlexPen Aspart 100 3ML CCH,2018-01-02 21:00:00,10452,10422,30,20,246,2.66666666666667
2,FlexPen Aspart 100 3ML CCH,2018-01-02 22:00:00,9747,9666,81,33,374,2.66666666666667
2,FlexPen Aspart 100 3ML CCH,2018-01-02 23:00:00,10380,10314,66,28,212,2.66666666666667
2,FlexPen Aspart 100 3ML CCH,2018-01-03 00:00:00,9776,9666,110,29,472,2.66666666666667
2,FlexPen Aspart 100 3ML CCH,2018-01-03 01:00:00,9232,9180,52,72,544,2.66666666666667
2,FlexPen Aspart 100 3ML CCH,2018-01-03 02:00:00,9872,9882,-10,55,214,2.66666666666667
2,FlexPen Aspart 100 3ML CCH,2018-01-03 03:00:00,9264,9180,84,57,500,2.66666666666667
2,FlexPen Aspart 100 3ML CCH,2018-01-03 04:00:00,1304,1332,-28,18,3050,2.66666666666667
2,NovoMix 30 GLY (CCH),2018-01-03 04:00:00,1304,1332,-28,18,3050,2.66666666666667
2,NovoMix 30 GLY (CCH),2018-01-03 05:00:00,10288,10152,136,81,276,2.66666666666667
2,NovoMix 30 GLY (CCH),2018-01-03 06:00:00,5239,5292,-53,11,2798,2.66666666666667
2,NovoMix 30 GLY (CCH),2018-01-03 07:00:00,6496,6426,70,19,374,2.66666666666667
2,NovoMix 30 GLY (CCH),2018-01-03 08:00:00,9823,9828,-5,23,430,2.66666666666667
2,NovoMix 30 GLY (CCH),2018-01-03 09:00:00,9296,9270,26,63,642,2.66666666666667
2,NovoMix 30 GLY (CCH),2018-01-03 10:00:00,5856,5670,186,33,1556,2.66666666666667
2,NovoMix 30 GLY (CCH),2018-01-03 11:00:00,9712,9666,46,24,382,2.66666666666667
2,NovoMix 30 GLY (CCH),2018-01-03 12:00:00,10056,10098,-42,44,338,2.66666666666667
2,NovoMix 30 GLY (CCH),2018-01-03 13:00:00,8024,7884,140,37,950,2.66666666666667
2,NovoMix 30 GLY (CCH),2018-01-03 14:00:00,9562,9558,4,30,408,2.66666666666667
2,NovoMix 30 GLY (CCH),2018-01-03 15:00:00,10388,10260,128,34,258,2.66666666666667
2,NovoMix 30 GLY (CCH),2018-01-03 16:00:00,10380,10314,66,60,242,2.66666666666667
2,NovoMix 30 GLY (CCH),2018-01-03 17:00:00,9464,9450,14,21,508,2.66666666666667
2,NovoMix 30 GLY (CCH),2018-01-03 18:00:00,4134,3996,138,22,994,2.66666666666667
2,NovoMix 30 GLY (CCH),2018-01-03 19:00:00,5912,5832,80,1,3866,2.66666666666667
2,NovoMix 30 GLY (CCH),2018-01-03 20:00:00,5844,5832,12,17,3322,2.66666666666667
2,NovoMix 30 GLY (CCH),2018-01-03 21:00:00,10183,10206,-23,18,130,2.66666666666667
2,NovoMix 30 GLY (CCH),2018-01-03 22:00:00,10272,10260,12,32,220,2.66666666666667
2,NovoMix 30 GLY (CCH),2018-01-03 23:00:00,10032,9936,96,40,200,2.66666666666667
2,NovoMix 30 GLY (CCH),2018-01-04 00:00:00,8572,8478,94,31,300,2.66666666666667
2,NovoMix 30 GLY (CCH),2018-01-04 01:00:00,10136,10044,92,34,860,2.66666666666667
2,NovoMix 30 GLY (CCH),2018-01-04 02:00:00,8567,8532,35,31,238,2.66666666666667
2,NovoMix 30 GLY (CCH),2018-01-04 03:00:00,10331,10260,71,36,580,2.66666666666667
2,NovoMix 30 GLY (CCH),2018-01-04 04:00:00,9960,9882,78,44,182,2.66666666666667
2,NovoMix 30 GLY (CCH),2018-01-04 05:00:00,10532,10584,-52,37,136,2.66666666666667
2,NovoMix 30 GLY (CCH),2018-01-04 06:00:00,10620,10476,144,26,210,2.66666666666667
2,NovoMix 30 GLY (CCH),2018-01-04 07:00:00,9154,9126,28,20,136,2.66666666666667
2,NovoMix 30 GLY (CCH),2018-01-04 08:00:00,10076,10044,32,28,606,2.66666666666667
2,NovoMix 30 GLY (CCH),2018-01-04 09:00:00,10296,10260,36,28,272,2.66666666666667
2,NovoMix 30 GLY (CCH),2018-01-04 10:00:00,9768,9666,102,28,450,2.66666666666667
2,NovoMix 30 GLY (CCH),2018-01-04 11:00:00,9536,9558,-22,30,3222,2.66666666666667
2,NovoMix 30 GLY (CCH),2018-01-04 12:00:00,7762,8154,-392,31,322,2.66666666666667
2,NovoMix 30 GLY (CCH),2018-01-04 13:00:00,3522,2970,552,22,318,2.66666666666667
2,NovoMix 30 GLY (CCH),2018-01-04 14:00:00,9892,9828,64,17,3482,2.66666666666667
2,NovoMix 30 GLY (CCH),2018-01-04 15:00:00,5144,5022,122,45,714,2.66666666666667
2,NovoMix 30 GLY (CCH),2018-01-04 16:00:00,2914,2808,106,34,304,2
2,NovoMix 30 GLY (CCH),2018-01-04 17:00:00,9268,9234,34,71,846,2
2,NovoMix 30 GLY (CCH),2018-01-04 18:00:00,8464,8478,-14,28,322,2
2,NovoMix 30 GLY (CCH),2018-01-04 19:00:00,10139,10044,95,62,408,2
2,NovoMix 30 GLY (CCH),2018-01-04 20:00:00,9536,9504,32,49,1074,2
2,NovoMix 30 GLY (CCH),2018-01-04 21:00:00,7904,7884,20,53,1130,2
2,NovoMix 30 GLY (CCH),2018-01-04 22:00:00,7868,7776,92,29,244,2
2,NovoMix 30 GLY (CCH),2018-01-04 23:00:00,9948,9882,66,42,392,2
2,NovoMix 30 GLY (CCH),2018-01-05 00:00:00,9888,9828,60,47,374,2
2,NovoMix 30 GLY (CCH),2018-01-05 01:00:00,10358,10260,98,25,82,2
2,NovoMix 30 GLY (CCH),2018-01-05 02:00:00,10210,10152,58,41,344,2
2,NovoMix 30 GLY (CCH),2018-01-05 03:00:00,9828,9720,108,38,264,2
2,NovoMix 30 GLY (CCH),2018-01-05 04:00:00,9856,9882,-26,51,316,2
2,NovoMix 30 GLY (CCH),2018-01-05 05:00:00,9696,9720,-24,65,498,2
2,NovoMix 30 GLY (CCH),2018-01-05 06:00:00,9340,9072,268,67,254,2
2,NovoMix 30 GLY (CCH),2018-01-05 07:00:00,9466,9450,16,48,944,2
2,NovoMix 30 GLY (CCH),2018-01-05 08:00:00,9830,9720,110,1,8330,2
2,NovoMix 30 GLY (CCH),2018-01-05 09:00:00,8088,7938,150,23,436,2
2,NovoMix 30 GLY (CCH),2018-01-05 10:00:00,9740,9774,-34,100,428,2
2,NovoMix 30 GLY (CCH),2018-01-05 11:00:00,9712,9558,154,4,854,2
2,NovoMix 30 GLY (CCH),2018-01-05 12:00:00,3450,4014,-564,38,454,2
2,NovoMix 50 NN2000,2018-01-05 13:00:00,3598,3024,574,2,8004,2
2,NovoMix 50 NN2000,2018-01-05 14:00:00,4924,4860,64,8,176,2
2,NovoMix 50 NN2000,2018-01-05 15:00:00,4996,4806,190,44,3692,2
2,NovoMix 50 NN2000,2018-01-05 16:00:00,8016,7884,132,17,334,2
2,NovoMix 50 NN2000,2018-01-05 17:00:00,4797,4590,207,35,2166,2
2,NovoMix 50 NN2000,2018-01-05 18:00:00,8776,8694,82,18,604,2
2,NovoMix 50 NN2000,2018-01-05 19:00:00,6784,6804,-20,36,582,2
2,NovoMix 50 NN2000,2018-01-05 20:00:00,7800,7614,186,69,1344,2
2,NovoMix 50 NN2000,2018-01-05 21:00:00,9072,8856,216,71,1008,2
2,NovoMix 50 NN2000,2018-01-05 22:00:00,1686,2178,-492,53,712,2
2,Detemir Gly (CCH),2018-01-06 07:00:00,5534,4914,620,32,264,2
2,Detemir Gly (CCH),2018-01-06 08:00:00,10088,10044,44,19,850,2
2,Detemir Gly (CCH),2018-01-06 09:00:00,10628,10584,44,31,336,2
2,Detemir Gly (CCH),2018-01-06 10:00:00,10372,10314,58,43,154,2
2,Detemir Gly (CCH),2018-01-06 11:00:00,10210,10098,112,27,266,2
2,Detemir Gly (CCH),2018-01-06 12:00:00,7834,7830,4,34,168,2
2,Detemir Gly (CCH),2018-01-06 13:00:00,10764,10638,126,28,1056,2
2,Detemir Gly (CCH),2018-01-06 14:00:00,5354,5832,-478,22,336,2
2,Detemir Gly (CCH),2018-01-07 06:00:00,2882,2268,614,69,726,2.4
2,Detemir Gly (CCH),2018-01-07 07:00:00,9892,9828,64,10,70,4
2,Detemir Gly (CCH),2018-01-07 08:00:00,10512,10476,36,25,266,4
2,Detemir Gly (CCH),2018-01-07 09:00:00,10652,10584,68,25,170,4
2,Detemir Gly (CCH),2018-01-07 10:00:00,9320,9504,-184,27,120,4
2,Detemir Gly (CCH),2018-01-07 11:00:00,10344,10044,300,61,640,4
2,Detemir Gly (CCH),2018-01-07 12:00:00,9956,9936,20,32,250,4
2,Detemir Gly (CCH),2018-01-07 13:00:00,10412,10260,152,49,292,4
2,Detemir Gly (CCH),2018-01-07 14:00:00,10344,10314,30,27,152,4
2,Detemir Gly (CCH),2018-01-07 15:00:00,10064,9990,74,26,232,4
2,Detemir Gly (CCH),2018-01-07 16:00:00,4190,4716,-526,22,378,4
2,FlexPen Aspart 100 3ML CCH,2018-01-07 17:00:00,7653,7020,633,46,3170,4
2,FlexPen Aspart 100 3ML CCH,2018-01-07 18:00:00,7728,7722,6,21,168,4
2,FlexPen Aspart 100 3ML CCH,2018-01-07 19:00:00,6948,6804,144,46,1082,4
2,FlexPen Aspart 100 3ML CCH,2018-01-07 20:00:00,10080,10044,36,32,1404,4
2,FlexPen Aspart 100 3ML CCH,2018-01-07 21:00:00,9248,9234,14,26,378,4
2,FlexPen Aspart 100 3ML CCH,2018-01-07 22:00:00,10452,10368,84,36,474,4
2,FlexPen Aspart 100 3ML CCH,2018-01-07 23:00:00,9584,9504,80,23,214,4
2,FlexPen Aspart 100 3ML CCH,2018-01-08 00:00:00,10696,10638,58,79,496,4
2,FlexPen Aspart 100 3ML CCH,2018-01-08 01:00:00,10316,10260,56,30,138,4
2,FlexPen Aspart 100 3ML CCH,2018-01-08 02:00:00,9448,9342,106,25,282,4
2,FlexPen Aspart 100 3ML CCH,2018-01-08 03:00:00,10160,10152,8,27,426,4
2,FlexPen Aspart 100 3ML CCH,2018-01-08 04:00:00,10696,10638,58,43,258,4
2,FlexPen Aspart 100 3ML CCH,2018-01-08 05:00:00,10412,10368,44,31,144,4
2,FlexPen Aspart 100 3ML CCH,2018-01-08 06:00:00,10848,10800,48,24,126,4
2,FlexPen Aspart 100 3ML CCH,2018-01-08 07:00:00,10224,10206,18,24,82,4
2,FlexPen Aspart 100 3ML CCH,2018-01-08 08:00:00,10700,10638,62,33,280,4
2,FlexPen Aspart 100 3ML CCH,2018-01-08 09:00:00,10688,10584,104,55,142,4
2,FlexPen Aspart 100 3ML CCH,2018-01-08 10:00:00,10804,10746,58,30,156,4
2,FlexPen Aspart 100 3ML CCH,2018-01-08 11:00:00,9819,9666,153,30,224,4
2,FlexPen Aspart 100 3ML CCH,2018-01-08 12:00:00,10836,10800,36,28,312,4
2,FlexPen Aspart 100 3ML CCH,2018-01-08 13:00:00,10472,10422,50,31,106,4
2,FlexPen Aspart 100 3ML CCH,2018-01-08 14:00:00,10915,10800,115,21,192,4
2,FlexPen Aspart 100 3ML CCH,2018-01-08 15:00:00,9918,9882,36,26,116,4
2,FlexPen Aspart 100 3ML CCH,2018-01-08 16:00:00,2746,3294,-548,26,356,4
2,FlexPen Aspart 100 3ML CCH,2018-01-08 17:00:00,4674,4050,624,13,4246,4
2,FlexPen Aspart 100 3ML CCH,2018-01-08 18:00:00,9900,9882,18,47,1648,4
2,FlexPen Aspart 100 3ML CCH,2018-01-08 19:00:00,8668,8586,82,50,466,4
2,FlexPen Aspart 100 3ML CCH,2018-01-08 20:00:00,8995,8910,85,65,528,4
2,FlexPen Aspart 100 3ML CCH,2018-01-08 21:00:00,4752,4698,54,67,212,4
2,FlexPen Aspart 100 3ML CCH,2018-01-08 22:00:00,8948,8910,38,54,280,4
2,FlexPen Aspart 100 3ML CCH,2018-01-08 23:00:00,10564,10530,34,61,564,4
2,FlexPen Aspart 100 3ML CCH,2018-01-09 00:00:00,10256,10152,104,42,612,4
2,FlexPen Aspart 100 3ML CCH,2018-01-09 01:00:00,10488,10476,12,40,584,4
2,FlexPen Aspart 100 3ML CCH,2018-01-09 02:00:00,9520,9396,124,27,270,4
2,FlexPen Aspart 100 3ML CCH,2018-01-09 03:00:00,6596,6588,8,53,758,4
2,FlexPen Aspart 100 3ML CCH,2018-01-09 04:00:00,8344,8262,82,42,994,4
2,FlexPen Aspart 100 3ML CCH,2018-01-09 05:00:00,9935,9882,53,23,1328,4
2,FlexPen Aspart 100 3ML CCH,2018-01-09 06:00:00,6172,6102,70,33,456,3.66666666666667
2,FlexPen Aspart 100 3ML CCH,2018-01-09 07:00:00,9240,9234,6,54,504,3
2,FlexPen Aspart 100 3ML CCH,2018-01-09 08:00:00,9584,9558,26,70,572,3
2,FlexPen Aspart 100 3ML CCH,2018-01-09 09:00:00,8116,8208,-92,41,1162,3
2,FlexPen Aspart 100 3ML CCH,2018-01-09 10:00:00,8056,7830,226,22,1958,3
2,FlexPen Aspart 100 3ML CCH,2018-01-09 11:00:00,10416,10422,-6,34,274,3
2,FlexPen Aspart 100 3ML CCH,2018-01-09 12:00:00,10684,10530,154,46,3256,3
2,FlexPen Aspart 100 3ML CCH,2018-01-09 13:00:00,9317,9288,29,14,118,3
2,FlexPen Aspart 100 3ML CCH,2018-01-09 14:00:00,8916,8856,60,33,278,3
2,FlexPen Aspart 100 3ML CCH,2018-01-09 15:00:00,10308,10206,102,58,554,3
2,FlexPen Aspart 100 3ML CCH,2018-01-09 16:00:00,8644,8694,-50,39,372,3
2,FlexPen Aspart 100 3ML CCH,2018-01-09 17:00:00,7628,7344,284,53,840,3
2,FlexPen Aspart 100 3ML CCH,2018-01-09 18:00:00,9159,9126,33,52,514,3
2,FlexPen Aspart 100 3ML CCH,2018-01-09 19:00:00,8470,8982,-512,30,638,3
2,NovoMix 30 GLY (CCH),2018-01-09 21:00:00,8434,7884,550,35,622,3
2,NovoMix 30 GLY (CCH),2018-01-09 22:00:00,9368,9234,134,52,510,3
2,NovoMix 30 GLY (CCH),2018-01-09 23:00:00,9110,9072,38,64,588,3
2,NovoMix 30 GLY (CCH),2018-01-10 00:00:00,8396,8370,26,60,718,3
2,NovoMix 30 GLY (CCH),2018-01-10 01:00:00,8296,8262,34,46,602,3
2,NovoMix 30 GLY (CCH),2018-01-10 02:00:00,9796,9666,130,33,318,3
2,NovoMix 30 GLY (CCH),2018-01-10 03:00:00,9976,9936,40,62,512,3
2,NovoMix 30 GLY (CCH),2018-01-10 04:00:00,8014,8046,-32,51,628,3
2,NovoMix 30 GLY (CCH),2018-01-10 05:00:00,9716,9612,104,35,1504,3
2,NovoMix 30 GLY (CCH),2018-01-10 06:00:00,9428,9342,86,62,614,3
2,NovoMix 30 GLY (CCH),2018-01-10 07:00:00,9398,9288,110,65,724,3
2,NovoMix 30 GLY (CCH),2018-01-10 08:00:00,6613,6588,25,76,808,3
2,NovoMix 30 GLY (CCH),2018-01-10 09:00:00,8331,8262,69,65,792,3
2,NovoMix 30 GLY (CCH),2018-01-10 10:00:00,10264,10206,58,57,1110,3
2,NovoMix 30 GLY (CCH),2018-01-10 11:00:00,7116,7128,-12,27,1340,3
2,NovoMix 30 GLY (CCH),2018-01-10 12:00:00,9096,9018,78,73,558,3
2,NovoMix 30 GLY (CCH),2018-01-10 13:00:00,10055,9936,119,75,620,3
2,NovoMix 30 GLY (CCH),2018-01-10 14:00:00,9793,9720,73,57,538,3
2,NovoMix 30 GLY (CCH),2018-01-10 15:00:00,4571,4752,-181,88,1254,3
2,NovoMix 30 GLY (CCH),2018-01-10 16:00:00,8852,8532,320,43,560,3
2,NovoMix 30 GLY (CCH),2018-01-10 17:00:00,8780,8694,86,47,2094,3
2,NovoMix 30 GLY (CCH),2018-01-10 18:00:00,9872,9936,-64,45,928,3
2,NovoMix 30 GLY (CCH),2018-01-10 19:00:00,10500,10368,132,44,1094,3
2,NovoMix 30 GLY (CCH),2018-01-10 20:00:00,9740,9666,74,48,4568,3
2,NovoMix 30 GLY (CCH),2018-01-10 21:00:00,9712,9666,46,8,846,3
2,NovoMix 30 GLY (CCH),2018-01-10 22:00:00,9220,9180,40,82,682,3
2,NovoMix 30 GLY (CCH),2018-01-10 23:00:00,10460,10422,38,82,406,3
2,NovoMix 30 GLY (CCH),2018-01-11 00:00:00,9724,9666,58,49,3740,3
2,NovoMix 30 GLY (CCH),2018-01-11 01:00:00,7896,7830,66,43,156,3
2,NovoMix 30 GLY (CCH),2018-01-11 02:00:00,9836,9828,8,67,632,3
2,NovoMix 30 GLY (CCH),2018-01-11 03:00:00,10408,10260,148,89,472,3
2,NovoMix 30 GLY (CCH),2018-01-11 04:00:00,9932,10044,-112,101,528,3
2,NovoMix 30 GLY (CCH),2018-01-11 05:00:00,9130,9018,112,60,2010,3
2,NovoMix 30 GLY (CCH),2018-01-11 06:00:00,9920,9774,146,119,1036,3
2,NovoMix 30 GLY (CCH),2018-01-11 07:00:00,5671,6174,-503,69,2636,3.5
2,NovoMix 50 NN2000,2018-01-11 09:00:00,8132,7830,302,67,2042,3.5
2,NovoMix 50 NN2000,2018-01-11 10:00:00,10020,9882,138,102,1670,3.5
2,NovoMix 50 NN2000,2018-01-11 11:00:00,9036,9126,-90,53,2814,3.5
2,NovoMix 50 NN2000,2018-01-11 12:00:00,5585,5868,-283,69,1830,3.5
2,FlexPen Aspart 100 3ML CCH,2018-01-11 13:00:00,1510,1026,484,42,1174,3.5
2,FlexPen Aspart 100 3ML CCH,2018-01-11 14:00:00,9852,9774,78,66,1028,3.5
2,FlexPen Aspart 100 3ML CCH,2018-01-11 15:00:00,10428,10260,168,37,544,3.5
2,FlexPen Aspart 100 3ML CCH,2018-01-11 16:00:00,9376,9396,-20,53,2010,3.5
2,FlexPen Aspart 100 3ML CCH,2018-01-11 17:00:00,8120,8100,20,72,1916,3.5
2,FlexPen Aspart 100 3ML CCH,2018-01-11 18:00:00,9900,9720,180,91,1440,3.5
2,FlexPen Aspart 100 3ML CCH,2018-01-11 19:00:00,9398,9396,2,116,4960,3.5
2,FlexPen Aspart 100 3ML CCH,2018-01-11 20:00:00,7784,7830,-46,2,412,3.5
2,FlexPen Aspart 100 3ML CCH,2018-01-11 21:00:00,8830,8586,244,37,532,3.5
2,FlexPen Aspart 100 3ML CCH,2018-01-11 22:00:00,9060,8964,96,45,538,3.5
2,FlexPen Aspart 100 3ML CCH,2018-01-11 23:00:00,8784,8856,-72,62,1182,3.5
2,FlexPen Aspart 100 3ML CCH,2018-01-12 00:00:00,3772,3726,46,103,934,3.5
2,FlexPen Aspart 100 3ML CCH,2018-01-12 01:00:00,5980,5778,202,58,1358,3.5
2,FlexPen Aspart 100 3ML CCH,2018-01-12 02:00:00,9980,9936,44,69,1148,3.5
2,FlexPen Aspart 100 3ML CCH,2018-01-12 03:00:00,9968,10098,-130,50,780,3.5
2,FlexPen Aspart 100 3ML CCH,2018-01-12 04:00:00,9480,9234,246,45,2216,3.5
2,FlexPen Aspart 100 3ML CCH,2018-01-12 05:00:00,10296,10260,36,43,796,3.5
2,FlexPen Aspart 100 3ML CCH,2018-01-12 06:00:00,10340,10314,26,57,974,3.5
2,FlexPen Aspart 100 3ML CCH,2018-01-12 07:00:00,10172,10152,20,43,1632,3.5
2,FlexPen Aspart 100 3ML CCH,2018-01-12 08:00:00,10116,9990,126,39,664,3.5
2,FlexPen Aspart 100 3ML CCH,2018-01-12 09:00:00,9076,8964,112,52,512,3.5
2,FlexPen Aspart 100 3ML CCH,2018-01-12 10:00:00,1476,1512,-36,30,4132,3.5
2,FlexPen Aspart 100 3ML CCH,2018-01-12 11:00:00,4692,4698,-6,14,8406,3.5
2,FlexPen Aspart 100 3ML CCH,2018-01-12 12:00:00,1987,2160,-173,28,2096,3.5
2,FlexPen Aspart 100 3ML CCH,2018-01-12 17:00:00,5664,5400,264,2,18356,3.5
2,FlexPen Aspart 100 3ML CCH,2018-01-12 18:00:00,10188,10098,90,33,942,3.5
2,FlexPen Aspart 100 3ML CCH,2018-01-12 19:00:00,9932,9828,104,34,260,3.5
2,FlexPen Aspart 100 3ML CCH,2018-01-12 20:00:00,6556,6570,-14,37,988,3.5
2,FlexPen Aspart 100 3ML CCH,2018-01-12 21:00:00,9076,9558,-482,66,882,3.5
2,FlexPen Aspart 100 3ML CCH,2018-01-14 07:00:00,670,108,562,55,378,3.5
2,FlexPen Aspart 100 3ML CCH,2018-01-14 08:00:00,9147,9018,129,23,266,3.5
2,FlexPen Aspart 100 3ML CCH,2018-01-14 09:00:00,6824,6858,-34,46,412,3.5
2,FlexPen Aspart 100 3ML CCH,2018-01-14 10:00:00,10019,9936,83,79,794,3.5
2,FlexPen Aspart 100 3ML CCH,2018-01-14 11:00:00,10319,10314,5,47,832,3.5
2,FlexPen Aspart 100 3ML CCH,2018-01-14 12:00:00,9756,9558,198,55,4958,3.5
2,FlexPen Aspart 100 3ML CCH,2018-01-14 13:00:00,9614,9558,56,5,58,3.5
2,FlexPen Aspart 100 3ML CCH,2018-01-14 14:00:00,10644,10584,60,50,412,3.5
2,FlexPen Aspart 100 3ML CCH,2018-01-14 15:00:00,9047,8964,83,69,470,3.5
2,FlexPen Aspart 100 3ML CCH,2018-01-14 16:00:00,9206,9234,-28,62,152,3.5
2,FlexPen Aspart 100 3ML CCH,2018-01-14 17:00:00,9023,8856,167,49,414,3.5
2,FlexPen Aspart 100 3ML CCH,2018-01-14 18:00:00,8675,8586,89,56,376,3.5
2,FlexPen Aspart 100 3ML CCH,2018-01-14 19:00:00,9244,9180,64,46,304,3.5
2,FlexPen Aspart 100 3ML CCH,2018-01-14 20:00:00,7708,7776,-68,52,170,3.5
2,FlexPen Aspart 100 3ML CCH,2018-01-14 21:00:00,8162,7938,224,68,620,3.5
2,FlexPen Aspart 100 3ML CCH,2018-01-14 22:00:00,8909,8910,-1,69,438,3.5
2,FlexPen Aspart 100 3ML CCH,2018-01-14 23:00:00,9780,9558,222,53,538,3.5
2,FlexPen Aspart 100 3ML CCH,2018-01-15 00:00:00,5554,5562,-8,19,2878,3.5
2,FlexPen Aspart 100 3ML CCH,2018-01-15 01:00:00,1711,1512,199,47,566,3
2,FlexPen Aspart 100 3ML CCH,2018-01-15 02:00:00,8952,8856,96,50,582,3
2,FlexPen Aspart 100 3ML CCH,2018-01-15 03:00:00,9971,9936,35,53,1584,3
2,FlexPen Aspart 100 3ML CCH,2018-01-15 04:00:00,9332,9234,98,82,486,3
2,FlexPen Aspart 100 3ML CCH,2018-01-15 05:00:00,9052,9018,34,40,640,3
2,FlexPen Aspart 100 3ML CCH,2018-01-15 06:00:00,10172,10098,74,32,628,3
2,FlexPen Aspart 100 3ML CCH,2018-01-15 07:00:00,10108,10044,64,28,546,3
2,FlexPen Aspart 100 3ML CCH,2018-01-15 08:00:00,2154,2718,-564,45,504,3
2,NovoMix 30 GLY (CCH),2018-01-15 09:00:00,5874,5238,636,38,452,4
2,NovoMix 30 GLY (CCH),2018-01-15 10:00:00,10220,10260,-40,42,510,4
2,NovoMix 30 GLY (CCH),2018-01-15 11:00:00,9560,9450,110,69,254,4
2,NovoMix 30 GLY (CCH),2018-01-15 12:00:00,10016,10044,-28,24,226,4
2,NovoMix 30 GLY (CCH),2018-01-15 13:00:00,9932,9828,104,40,448,4
2,NovoMix 30 GLY (CCH),2018-01-15 14:00:00,9601,9612,-11,29,190,4
2,NovoMix 30 GLY (CCH),2018-01-15 15:00:00,9476,9342,134,20,262,4
2,NovoMix 30 GLY (CCH),2018-01-15 16:00:00,9580,9612,-32,7,58,4
2,NovoMix 30 GLY (CCH),2018-01-15 17:00:00,8656,8478,178,39,366,4
2,NovoMix 30 GLY (CCH),2018-01-15 18:00:00,9171,9126,45,33,314,4
2,NovoMix 30 GLY (CCH),2018-01-15 19:00:00,8648,8694,-46,52,544,4
2,NovoMix 30 GLY (CCH),2018-01-15 20:00:00,3364,3294,70,75,502,4
2,NovoMix 30 GLY (CCH),2018-01-15 21:00:00,4376,4482,-106,20,3498,4
2,NovoMix 30 GLY (CCH),2018-01-15 22:00:00,4708,4536,172,39,1238,4
2,NovoMix 30 GLY (CCH),2018-01-15 23:00:00,4704,4644,60,39,2040,4
2,NovoMix 30 GLY (CCH),2018-01-16 00:00:00,8328,8262,66,47,528,3.5
2,NovoMix 30 GLY (CCH),2018-01-16 01:00:00,10444,10368,76,47,580,3
2,NovoMix 30 GLY (CCH),2018-01-16 02:00:00,10056,9990,66,57,608,3
2,NovoMix 30 GLY (CCH),2018-01-16 03:00:00,10168,10098,70,47,730,3
2,NovoMix 30 GLY (CCH),2018-01-16 04:00:00,9860,9828,32,55,690,3
2,NovoMix 30 GLY (CCH),2018-01-16 05:00:00,9301,9180,121,66,630,3
2,NovoMix 30 GLY (CCH),2018-01-16 06:00:00,9587,9558,29,85,726,3
2,NovoMix 30 GLY (CCH),2018-01-16 07:00:00,8512,8532,-20,77,524,3
2,NovoMix 30 GLY (CCH),2018-01-16 08:00:00,8158,7992,166,76,738,3
2,NovoMix 30 GLY (CCH),2018-01-16 09:00:00,7026,6912,114,82,1310,3
2,NovoMix 30 GLY (CCH),2018-01-16 10:00:00,8740,8856,-116,24,1990,3
2,NovoMix 30 GLY (CCH),2018-01-16 11:00:00,8190,7992,198,46,126,3
2,NovoMix 30 GLY (CCH),2018-01-16 12:00:00,7007,6858,149,66,508,3
2,NovoMix 30 GLY (CCH),2018-01-16 13:00:00,6495,6480,15,25,4090,3
2,NovoMix 30 GLY (CCH),2018-01-16 14:00:00,10008,9882,126,22,1400,3
2,NovoMix 30 GLY (CCH),2018-01-16 15:00:00,8948,9072,-124,34,1586,3
2,NovoMix 30 GLY (CCH),2018-01-16 16:00:00,9420,9180,240,30,2048,3
2,NovoMix 30 GLY (CCH),2018-01-16 17:00:00,9323,9288,35,65,5490,3
2,NovoMix 30 GLY (CCH),2018-01-16 18:00:00,7853,7884,-31,24,114,3
2,NovoMix 30 GLY (CCH),2018-01-16 19:00:00,5850,6210,-360,57,1952,3
2,FlexPen Aspart 100 3ML CCH,2018-01-16 20:00:00,1182,594,588,65,448,3
2,FlexPen Aspart 100 3ML CCH,2018-01-16 21:00:00,8864,8802,62,65,1810,3
2,FlexPen Aspart 100 3ML CCH,2018-01-16 22:00:00,8424,8424,0,60,416,3.66666666666667
2,FlexPen Aspart 100 3ML CCH,2018-01-16 23:00:00,7684,7614,70,67,646,4
2,FlexPen Aspart 100 3ML CCH,2018-01-17 00:00:00,9664,9612,52,57,1070,4
2,FlexPen Aspart 100 3ML CCH,2018-01-17 01:00:00,10522,10368,154,80,670,4
2,FlexPen Aspart 100 3ML CCH,2018-01-17 02:00:00,9439,9396,43,86,904,4
2,FlexPen Aspart 100 3ML CCH,2018-01-17 03:00:00,20,54,-34,19,158,4
2,FlexPen Aspart 100 3ML CCH,2018-01-17 07:00:00,5576,5508,68,58,16568,4
2,FlexPen Aspart 100 3ML CCH,2018-01-17 08:00:00,10024,9936,88,15,120,4
2,FlexPen Aspart 100 3ML CCH,2018-01-17 09:00:00,10532,10476,56,35,366,4
2,FlexPen Aspart 100 3ML CCH,2018-01-17 10:00:00,10316,10368,-52,26,138,4
2,FlexPen Aspart 100 3ML CCH,2018-01-17 11:00:00,9864,9666,198,27,224,4
2,FlexPen Aspart 100 3ML CCH,2018-01-17 12:00:00,10596,10584,12,46,428,4
2,FlexPen Aspart 100 3ML CCH,2018-01-17 13:00:00,10240,10098,142,20,64,4
2,FlexPen Aspart 100 3ML CCH,2018-01-17 14:00:00,10511,10368,143,24,282,4
2,FlexPen Aspart 100 3ML CCH,2018-01-17 15:00:00,7891,7938,-47,16,88,4
2,FlexPen Aspart 100 3ML CCH,2018-01-17 16:00:00,8845,8586,259,21,1156,4
2,FlexPen Aspart 100 3ML CCH,2018-01-17 17:00:00,10128,9990,138,26,414,4
2,FlexPen Aspart 100 3ML CCH,2018-01-17 18:00:00,10316,10206,110,33,300,4
2,FlexPen Aspart 100 3ML CCH,2018-01-17 19:00:00,9964,9882,82,24,144,4
2,FlexPen Aspart 100 3ML CCH,2018-01-17 20:00:00,6028,5886,142,26,408,4
2,FlexPen Aspart 100 3ML CCH,2018-01-17 21:00:00,10300,10206,94,23,1134,4
2,FlexPen Aspart 100 3ML CCH,2018-01-17 22:00:00,6136,6156,-20,22,210,4
2,FlexPen Aspart 100 3ML CCH,2018-01-17 23:00:00,308,108,200,67,5876,4
2,FlexPen Aspart 100 3ML CCH,2018-01-18 00:00:00,540,648,-108,8,2224,4
2,FlexPen Aspart 100 3ML CCH,2018-01-18 01:00:00,9819,9828,-9,75,678,4
2,FlexPen Aspart 100 3ML CCH,2018-01-18 02:00:00,8204,8154,50,99,1726,4
2,FlexPen Aspart 100 3ML CCH,2018-01-18 03:00:00,8697,8640,57,60,474,4
2,FlexPen Aspart 100 3ML CCH,2018-01-18 04:00:00,1136,1188,-52,46,2088,4
2,Aspart (CHH),2018-01-18 04:00:00,1136,1188,-52,46,2088,4
2,Aspart (CHH),2018-01-18 05:00:00,9616,9342,274,98,496,4
2,Aspart (CHH),2018-01-18 06:00:00,6364,6210,154,95,1260,4
2,Aspart (CHH),2018-01-18 15:00:00,6416,6480,-64,7,2978,4
2,Aspart (CHH),2018-01-18 16:00:00,10136,9936,200,53,824,4
2,Aspart (CHH),2018-01-18 17:00:00,10292,10206,86,37,238,4
2,Aspart (CHH),2018-01-18 18:00:00,6736,6696,40,28,248,4
2,Aspart (CHH),2018-01-18 19:00:00,9384,9288,96,28,1284,4
2,Aspart (CHH),2018-01-18 20:00:00,10199,10098,101,33,452,4
2,Aspart (CHH),2018-01-18 21:00:00,10308,10152,156,26,276,4
2,Aspart (CHH),2018-01-18 22:00:00,9876,9828,48,26,98,4
2,Aspart (CHH),2018-01-18 23:00:00,10022,9936,86,43,416,4
2,Aspart (CHH),2018-01-19 00:00:00,9992,9936,56,35,286,4
2,Aspart (CHH),2018-01-19 01:00:00,8444,8316,128,41,296,4
2,Aspart (CHH),2018-01-19 02:00:00,8088,7992,96,46,898,4
2,Aspart (CHH),2018-01-19 03:00:00,10368,10314,54,63,902,4
2,Aspart (CHH),2018-01-19 04:00:00,10508,10422,86,36,312,4
2,Aspart (CHH),2018-01-19 05:00:00,10248,10152,96,20,90,4
2,Aspart (CHH),2018-01-19 06:00:00,7382,7884,-502,41,326,4
2,FlexPen Aspart 100 3ML CCH,2018-01-19 07:00:00,1930,1350,580,24,2702,4
2,FlexPen Aspart 100 3ML CCH,2018-01-19 08:00:00,9975,9882,93,9,1476,4.5
2,FlexPen Aspart 100 3ML CCH,2018-01-19 09:00:00,10365,10314,51,59,242,5
2,FlexPen Aspart 100 3ML CCH,2018-01-19 10:00:00,10209,10098,111,26,248,5
2,FlexPen Aspart 100 3ML CCH,2018-01-19 11:00:00,8660,8586,74,34,252,5
2,FlexPen Aspart 100 3ML CCH,2018-01-19 12:00:00,10122,10098,24,19,474,5
2,FlexPen Aspart 100 3ML CCH,2018-01-19 13:00:00,10378,10314,64,30,324,5
2,FlexPen Aspart 100 3ML CCH,2018-01-19 14:00:00,9128,9072,56,17,138,4.33333333333333
2,FlexPen Aspart 100 3ML CCH,2018-01-19 15:00:00,10535,10422,113,37,632,3
2,FlexPen Aspart 100 3ML CCH,2018-01-19 16:00:00,10052,9936,116,37,204,3
2,FlexPen Aspart 100 3ML CCH,2018-01-19 17:00:00,9808,9720,88,42,344,3
2,FlexPen Aspart 100 3ML CCH,2018-01-19 18:00:00,8923,8910,13,40,412,3
2,FlexPen Aspart 100 3ML CCH,2018-01-19 19:00:00,8491,8370,121,38,444,3
2,FlexPen Aspart 100 3ML CCH,2018-01-19 20:00:00,7575,7506,69,33,844,3
2,FlexPen Aspart 100 3ML CCH,2018-01-19 21:00:00,2592,2538,54,24,3592,3
2,FlexPen Aspart 100 3ML CCH,2018-01-19 22:00:00,7886,7830,56,23,316,3
2,FlexPen Aspart 100 3ML CCH,2018-01-19 23:00:00,10068,10044,24,38,28452,3
2,FlexPen Aspart 100 3ML CCH,2018-01-20 00:00:00,10452,10476,-24,24,1076,3
2,FlexPen Aspart 100 3ML CCH,2018-01-20 01:00:00,10748,10584,164,41,280,3
2,FlexPen Aspart 100 3ML CCH,2018-01-20 02:00:00,2006,2376,-370,35,154,3
2,FlexPen Aspart 100 3ML CCH,2018-01-20 03:00:00,10319,9828,491,32,114,3
2,FlexPen Aspart 100 3ML CCH,2018-01-20 04:00:00,7052,7050,2,17,3012,3
2,FlexPen Aspart 100 3ML CCH,2018-01-20 05:00:00,9972,9936,36,25,248,3
2,FlexPen Aspart 100 3ML CCH,2018-01-20 06:00:00,10088,10044,44,38,308,3
2,FlexPen Aspart 100 3ML CCH,2018-01-20 07:00:00,7845,7776,69,29,222,3
2,FlexPen Aspart 100 3ML CCH,2018-01-20 08:00:00,9605,9558,47,63,444,3
2,FlexPen Aspart 100 3ML CCH,2018-01-20 09:00:00,10300,10368,-68,42,376,3
2,FlexPen Aspart 100 3ML CCH,2018-01-20 10:00:00,9422,9288,134,34,232,3
2,FlexPen Aspart 100 3ML CCH,2018-01-20 11:00:00,10410,10368,42,48,544,3
2,FlexPen Aspart 100 3ML CCH,2018-01-20 12:00:00,9372,9234,138,35,206,3
2,FlexPen Aspart 100 3ML CCH,2018-01-20 13:00:00,9412,9288,124,41,546,3
2,FlexPen Aspart 100 3ML CCH,2018-01-20 14:00:00,10296,10368,-72,22,594,3
2,FlexPen Aspart 100 3ML CCH,2018-01-20 15:00:00,10368,10260,108,57,57780,3
2,FlexPen Aspart 100 3ML CCH,2018-01-20 16:00:00,10556,10422,134,16,226,3
2,FlexPen Aspart 100 3ML CCH,2018-01-20 17:00:00,9900,9990,-90,26,184,3
2,FlexPen Aspart 100 3ML CCH,2018-01-20 18:00:00,9476,9396,80,29,218,3
2,FlexPen Aspart 100 3ML CCH,2018-01-20 19:00:00,10675,10530,145,38,264,3
2,FlexPen Aspart 100 3ML CCH,2018-01-20 20:00:00,9768,9774,-6,32,474,3
2,FlexPen Aspart 100 3ML CCH,2018-01-20 21:00:00,9430,9396,34,22,196,3
2,FlexPen Aspart 100 3ML CCH,2018-01-20 22:00:00,10695,10638,57,34,412,3
2,FlexPen Aspart 100 3ML CCH,2018-01-20 23:00:00,10416,10314,102,26,494,3
2,FlexPen Aspart 100 3ML CCH,2018-01-21 00:00:00,3281,3294,-13,21,176,3
2,FlexPen Aspart 100 3ML CCH,2018-01-21 00:00:00,3281,3294,-13,21,176,3
2,FlexPen Aspart 100 3ML CCH,2018-01-21 01:00:00,9592,9504,88,18,202,3
2,FlexPen Aspart 100 3ML CCH,2018-01-21 02:00:00,10455,10368,87,18,2470,3
2,FlexPen Aspart 100 3ML CCH,2018-01-21 03:00:00,9286,9180,106,26,460,3
2,FlexPen Aspart 100 3ML CCH,2018-01-21 04:00:00,9448,9396,52,39,196,3
2,FlexPen Aspart 100 3ML CCH,2018-01-21 05:00:00,10152,10152,0,39,574,3
2,FlexPen Aspart 100 3ML CCH,2018-01-21 06:00:00,10480,10368,112,33,156,3
2,FlexPen Aspart 100 3ML CCH,2018-01-21 07:00:00,9224,9126,98,37,360,3
2,FlexPen Aspart 100 3ML CCH,2018-01-21 08:00:00,10092,10098,-6,66,470,3
2,FlexPen Aspart 100 3ML CCH,2018-01-21 09:00:00,9396,9396,0,49,340,3
2,FlexPen Aspart 100 3ML CCH,2018-01-21 10:00:00,10132,9990,142,56,520,3
2,FlexPen Aspart 100 3ML CCH,2018-01-21 11:00:00,10488,10368,120,32,176,3
2,FlexPen Aspart 100 3ML CCH,2018-01-21 12:00:00,9784,9666,118,25,224,3
2,FlexPen Aspart 100 3ML CCH,2018-01-21 13:00:00,10298,10260,38,30,336,3
2,FlexPen Aspart 100 3ML CCH,2018-01-21 14:00:00,8759,8802,-43,24,150,3
2,FlexPen Aspart 100 3ML CCH,2018-01-21 15:00:00,8452,8262,190,49,562,3
2,FlexPen Aspart 100 3ML CCH,2018-01-21 16:00:00,7392,7398,-6,31,662,3
2,FlexPen Aspart 100 3ML CCH,2018-01-21 17:00:00,9185,9126,59,66,1160,3
2,FlexPen Aspart 100 3ML CCH,2018-01-21 18:00:00,1458,1908,-450,67,588,2
2,FlexPen Aspart 100 3ML CCH,2018-01-21 19:00:00,6432,5832,600,31,3934,2
2,FlexPen Aspart 100 3ML CCH,2018-01-21 20:00:00,10283,10260,23,46,414,2
2,FlexPen Aspart 100 3ML CCH,2018-01-21 21:00:00,9664,9612,52,49,370,2
2,FlexPen Aspart 100 3ML CCH,2018-01-21 22:00:00,8963,8856,107,25,310,2
2,FlexPen Aspart 100 3ML CCH,2018-01-21 23:00:00,9052,9018,34,42,340,2
2,FlexPen Aspart 100 3ML CCH,2018-01-22 00:00:00,10600,10530,70,21,618,2
2,FlexPen Aspart 100 3ML CCH,2018-01-22 01:00:00,10860,10746,114,28,196,2
2,FlexPen Aspart 100 3ML CCH,2018-01-22 02:00:00,10848,10800,48,24,98,2
2,FlexPen Aspart 100 3ML CCH,2018-01-22 03:00:00,9832,9882,-50,19,64,2
2,FlexPen Aspart 100 3ML CCH,2018-01-22 04:00:00,10040,9990,50,33,456,2
2,FlexPen Aspart 100 3ML CCH,2018-01-22 05:00:00,10064,9936,128,36,194,2
2,FlexPen Aspart 100 3ML CCH,2018-01-22 06:00:00,8227,8154,73,44,274,2
2,FlexPen Aspart 100 3ML CCH,2018-01-22 07:00:00,8786,8802,-16,48,1266,2
2,FlexPen Aspart 100 3ML CCH,2018-01-22 08:00:00,9580,9450,130,32,360,2
2,FlexPen Aspart 100 3ML CCH,2018-01-22 09:00:00,9702,9612,90,36,454,2
2,FlexPen Aspart 100 3ML CCH,2018-01-22 10:00:00,9860,9828,32,40,336,2
2,FlexPen Aspart 100 3ML CCH,2018-01-22 11:00:00,9324,9288,36,40,278,2
2,FlexPen Aspart 100 3ML CCH,2018-01-22 12:00:00,9576,9504,72,34,438,2
2,FlexPen Aspart 100 3ML CCH,2018-01-22 13:00:00,8844,8748,96,37,478,2
2,FlexPen Aspart 100 3ML CCH,2018-01-22 14:00:00,9908,9990,-82,63,654,2
2,FlexPen Aspart 100 3ML CCH,2018-01-22 15:00:00,7114,6966,148,31,562,2
2,FlexPen Aspart 100 3ML CCH,2018-01-22 16:00:00,8822,8802,20,24,880,2
2,FlexPen Aspart 100 3ML CCH,2018-01-22 17:00:00,8768,8748,20,56,662,2
2,FlexPen Aspart 100 3ML CCH,2018-01-22 18:00:00,8831,8748,83,40,416,2
2,FlexPen Aspart 100 3ML CCH,2018-01-22 19:00:00,2582,3060,-478,25,160,2
2,FlexPen Aspart 100 3ML CCH,2018-01-22 21:00:00,1140,864,276,41,440,2
2,FlexPen Aspart 100 3ML CCH,2018-01-22 22:00:00,8696,8748,-52,54,1278,3
2,FlexPen Aspart 100 3ML CCH,2018-01-22 23:00:00,10779,10692,87,50,158,3
2,FlexPen Aspart 100 3ML CCH,2018-01-23 00:00:00,4012,3888,124,6,3376,3
2,FlexPen Aspart 100 3ML CCH,2018-01-23 01:00:00,6636,6696,-60,52,1634,3
2,FlexPen Aspart 100 3ML CCH,2018-01-23 02:00:00,9464,9342,122,88,680,3
2,FlexPen Aspart 100 3ML CCH,2018-01-23 03:00:00,8892,8910,-18,89,460,3
2,FlexPen Aspart 100 3ML CCH,2018-01-23 04:00:00,7812,7668,144,67,410,3
2,FlexPen Aspart 100 3ML CCH,2018-01-23 05:00:00,7876,7884,-8,64,466,3
2,FlexPen Aspart 100 3ML CCH,2018-01-23 06:00:00,10054,9936,118,152,546,3
2,FlexPen Aspart 100 3ML CCH,2018-01-23 07:00:00,9437,9342,95,36,4450,3
2,FlexPen Aspart 100 3ML CCH,2018-01-23 08:00:00,8240,8262,-22,31,458,3
2,FlexPen Aspart 100 3ML CCH,2018-01-23 09:00:00,4556,4590,-34,1,17102,3
2,FlexPen Aspart 100 3ML CCH,2018-01-23 10:00:00,4942,4752,190,19,2590,3
2,FlexPen Aspart 100 3ML CCH,2018-01-23 11:00:00,1388,1404,-16,24,970,3
2,FlexPen Aspart 100 3ML CCH,2018-01-23 12:00:00,8943,8856,87,43,522,3
2,FlexPen Aspart 100 3ML CCH,2018-01-23 13:00:00,9461,9342,119,39,400,3
2,FlexPen Aspart 100 3ML CCH,2018-01-23 14:00:00,10032,9990,42,32,330,3
2,FlexPen Aspart 100 3ML CCH,2018-01-23 15:00:00,9892,9828,64,27,870,3
2,FlexPen Aspart 100 3ML CCH,2018-01-23 16:00:00,8952,8856,96,14,3914,3
2,FlexPen Aspart 100 3ML CCH,2018-01-23 17:00:00,7992,7938,54,27,1506,3
2,FlexPen Aspart 100 3ML CCH,2018-01-23 18:00:00,6556,6534,22,130,1268,3
2,FlexPen Aspart 100 3ML CCH,2018-01-23 19:00:00,8979,8964,15,121,820,3
2,FlexPen Aspart 100 3ML CCH,2018-01-23 20:00:00,9684,9558,126,113,880,3
2,FlexPen Aspart 100 3ML CCH,2018-01-23 21:00:00,9279,9234,45,50,386,3
2,FlexPen Aspart 100 3ML CCH,2018-01-23 22:00:00,10043,10044,-1,63,862,3
2,FlexPen Aspart 100 3ML CCH,2018-01-23 23:00:00,9440,9342,98,67,516,3
2,FlexPen Aspart 100 3ML CCH,2018-01-24 00:00:00,10232,10152,80,58,146,3
2,FlexPen Aspart 100 3ML CCH,2018-01-24 01:00:00,9676,9612,64,87,596,3
2,FlexPen Aspart 100 3ML CCH,2018-01-24 02:00:00,8852,8748,104,54,348,3
2,FlexPen Aspart 100 3ML CCH,2018-01-24 03:00:00,6646,7218,-572,39,422,3
2,FlexPen Aspart 100 3ML CCH,2018-01-24 04:00:00,715,270,445,50,356,3
2,FlexPen Aspart 100 3ML CCH,2018-01-24 05:00:00,8892,8694,198,58,228,3
2,FlexPen Aspart 100 3ML CCH,2018-01-24 06:00:00,10580,10530,50,20,252,3
2,FlexPen Aspart 100 3ML CCH,2018-01-24 07:00:00,10180,10098,82,41,372,3
2,FlexPen Aspart 100 3ML CCH,2018-01-24 08:00:00,10336,10314,22,108,708,3
2,FlexPen Aspart 100 3ML CCH,2018-01-24 09:00:00,8964,8910,54,83,686,3
2,FlexPen Aspart 100 3ML CCH,2018-01-24 10:00:00,4759,4752,7,19,434,3
2,FlexPen Aspart 100 3ML CCH,2018-01-24 11:00:00,80,0,80,32,3874,3
2,FlexPen Aspart 100 3ML CCH,2018-01-24 12:00:00,3664,3402,262,49,266,3
2,FlexPen Aspart 100 3ML CCH,2018-01-24 13:00:00,3063,3078,-15,21,300,3
2,FlexPen Aspart 100 3ML CCH,2018-01-24 14:00:00,6132,5994,138,32,308,3
2,FlexPen Aspart 100 3ML CCH,2018-01-24 15:00:00,10279,10152,127,48,384,3.33333333333333
2,FlexPen Aspart 100 3ML CCH,2018-01-24 16:00:00,10147,9936,211,29,230,4
2,FlexPen Aspart 100 3ML CCH,2018-01-24 17:00:00,9083,9126,-43,29,3026,4
2,FlexPen Aspart 100 3ML CCH,2018-01-24 18:00:00,10367,10206,161,18,6034,4
2,FlexPen Aspart 100 3ML CCH,2018-01-24 19:00:00,4834,4914,-80,2,1334,4
2,FlexPen Aspart 100 3ML CCH,2018-01-24 20:00:00,701,378,323,2,5962,4
2,FlexPen Aspart 100 3ML CCH,2018-01-24 21:00:00,172,162,10,48,310,4
2,FlexPen Aspart 100 3ML CCH,2018-01-24 22:00:00,184,108,76,44,400,4
2,FlexPen Aspart 100 3ML CCH,2018-01-24 23:00:00,112,108,4,55,324,4
2,FlexPen Aspart 100 3ML CCH,2018-01-25 00:00:00,5255,5184,71,40,1690,4
2,FlexPen Aspart 100 3ML CCH,2018-01-25 01:00:00,9568,9396,172,40,446,4
2,FlexPen Aspart 100 3ML CCH,2018-01-25 02:00:00,8984,8856,128,44,410,4
2,FlexPen Aspart 100 3ML CCH,2018-01-25 03:00:00,9724,9612,112,78,466,4
2,FlexPen Aspart 100 3ML CCH,2018-01-25 04:00:00,9652,9612,40,66,1096,4
2,FlexPen Aspart 100 3ML CCH,2018-01-25 05:00:00,9908,9774,134,46,530,4
2,FlexPen Aspart 100 3ML CCH,2018-01-25 06:00:00,9016,8964,52,51,580,4
2,FlexPen Aspart 100 3ML CCH,2018-01-25 07:00:00,5648,5562,86,89,324,4
2,FlexPen Aspart 100 3ML CCH,2018-01-25 08:00:00,8940,8964,-24,69,352,4
2,FlexPen Aspart 100 3ML CCH,2018-01-25 09:00:00,2800,2646,154,108,928,4
2,FlexPen Aspart 100 3ML CCH,2018-01-25 10:00:00,5732,5724,8,44,1060,4
2,FlexPen Aspart 100 3ML CCH,2018-01-25 11:00:00,9040,8856,184,72,920,4
2,FlexPen Aspart 100 3ML CCH,2018-01-25 12:00:00,9728,9666,62,82,298,4
2,FlexPen Aspart 100 3ML CCH,2018-01-25 13:00:00,3536,3510,26,100,616,4
2,FlexPen Aspart 100 3ML CCH,2018-01-25 14:00:00,6722,6696,26,91,682,4
2,FlexPen Aspart 100 3ML CCH,2018-01-25 15:00:00,5078,5526,-448,40,410,4
2,Aspart (CHH),2018-01-25 16:00:00,5422,4806,616,43,462,4
2,Aspart (CHH),2018-01-25 17:00:00,9840,9666,174,47,290,4
2,Aspart (CHH),2018-01-25 18:00:00,9916,9882,34,47,414,4
2,Aspart (CHH),2018-01-25 19:00:00,8100,7884,216,58,598,4
2,Aspart (CHH),2018-01-25 20:00:00,9380,9288,92,29,294,4
2,Aspart (CHH),2018-01-25 21:00:00,9912,9774,138,36,892,4
2,Aspart (CHH),2018-01-25 22:00:00,6020,5994,26,41,640,4
2,Aspart (CHH),2018-01-25 23:00:00,7874,8262,-388,52,892,4
2,Aspart (CHH),2018-01-26 00:00:00,0,36,-36,23,14644,4
2,NovoMix 50 NN2000,2018-01-26 01:00:00,6058,5530,528,20,660,4
2,NovoMix 50 NN2000,2018-01-26 02:00:00,8088,7912,176,45,720,4
2,NovoMix 50 NN2000,2018-01-26 03:00:00,9212,9180,32,30,638,4
2,NovoMix 50 NN2000,2018-01-26 04:00:00,9016,8911,105,63,836,4
2,NovoMix 50 NN2000,2018-01-26 05:00:00,9360,9342,18,57,852,4
2,NovoMix 50 NN2000,2018-01-26 06:00:00,8132,7993,139,98,926,3.33333333333333
2,NovoMix 50 NN2000,2018-01-26 07:00:00,8711,8587,124,53,716,3
2,NovoMix 50 NN2000,2018-01-26 08:00:00,8872,8802,70,52,994,3
2,NovoMix 50 NN2000,2018-01-26 09:00:00,2964,3529,-565,50,532,3
2,NovoMix 30 GLY (CCH),2018-01-26 10:00:00,9278,8640,638,55,722,3
2,NovoMix 30 GLY (CCH),2018-01-26 10:00:00,9278,8640,638,55,722,3
2,Testmedium (CCH),2018-01-26 10:00:00,9278,8640,638,55,722,3
2,NovoMix 30 GLY (CCH),2018-01-26 11:00:00,10656,10638,18,101,420,3
2,NovoMix 30 GLY (CCH),2018-01-26 11:00:00,10656,10638,18,101,420,3
2,Testmedium (CCH),2018-01-26 11:00:00,10656,10638,18,101,420,3
2,NovoMix 30 GLY (CCH),2018-01-26 12:00:00,7920,7884,36,74,444,3
2,NovoMix 30 GLY (CCH),2018-01-26 12:00:00,7920,7884,36,74,444,3
2,Testmedium (CCH),2018-01-26 12:00:00,7920,7884,36,74,444,3
2,NovoMix 30 GLY (CCH),2018-01-26 13:00:00,5292,5238,54,25,78,3
2,NovoMix 30 GLY (CCH),2018-01-26 13:00:00,5292,5238,54,25,78,3
2,Testmedium (CCH),2018-01-26 13:00:00,5292,5238,54,25,78,3
2,NovoMix 30 GLY (CCH),2018-01-26 14:00:00,9848,9720,128,93,580,3
2,NovoMix 30 GLY (CCH),2018-01-26 14:00:00,9848,9720,128,93,580,3
2,Testmedium (CCH),2018-01-26 14:00:00,9848,9720,128,93,580,3
2,NovoMix 30 GLY (CCH),2018-01-26 15:00:00,9452,9504,-52,77,600,3
2,NovoMix 30 GLY (CCH),2018-01-26 15:00:00,9452,9504,-52,77,600,3
2,Testmedium (CCH),2018-01-26 15:00:00,9452,9504,-52,77,600,3
2,NovoMix 30 GLY (CCH),2018-01-26 16:00:00,9294,9180,114,17,458,3
2,NovoMix 30 GLY (CCH),2018-01-26 16:00:00,9294,9180,114,17,458,3
2,Testmedium (CCH),2018-01-26 16:00:00,9294,9180,114,17,458,3
2,NovoMix 30 GLY (CCH),2018-01-26 17:00:00,10275,10152,123,44,610,3
2,NovoMix 30 GLY (CCH),2018-01-26 17:00:00,10275,10152,123,44,610,3
2,Testmedium (CCH),2018-01-26 17:00:00,10275,10152,123,44,610,3
2,NovoMix 30 GLY (CCH),2018-01-26 18:00:00,9820,9720,100,48,408,3
2,NovoMix 30 GLY (CCH),2018-01-26 18:00:00,9820,9720,100,48,408,3
2,Testmedium (CCH),2018-01-26 18:00:00,9820,9720,100,48,408,3
2,NovoMix 30 GLY (CCH),2018-01-26 19:00:00,9940,9882,58,47,416,3
2,NovoMix 30 GLY (CCH),2018-01-26 19:00:00,9940,9882,58,47,416,3
2,Testmedium (CCH),2018-01-26 19:00:00,9940,9882,58,47,416,3
2,NovoMix 30 GLY (CCH),2018-01-26 20:00:00,9824,9666,158,53,790,3
2,NovoMix 30 GLY (CCH),2018-01-26 20:00:00,9824,9666,158,53,790,3
2,Testmedium (CCH),2018-01-26 20:00:00,9824,9666,158,53,790,3
2,NovoMix 30 GLY (CCH),2018-01-26 21:00:00,1992,1998,-6,97,1608,3
2,NovoMix 30 GLY (CCH),2018-01-26 21:00:00,1992,1998,-6,97,1608,3
2,Testmedium (CCH),2018-01-26 21:00:00,1992,1998,-6,97,1608,3
2,NovoMix 30 GLY (CCH),2018-01-27 07:00:00,3944,3972,-28,112,4180,2.66666666666667
2,NovoMix 30 GLY (CCH),2018-01-27 07:00:00,3944,3972,-28,112,4180,2.66666666666667
2,Testmedium (CCH),2018-01-27 07:00:00,3944,3972,-28,112,4180,2.66666666666667
2,NovoMix 30 GLY (CCH),2018-01-27 08:00:00,9120,8964,156,7,384,3
2,NovoMix 30 GLY (CCH),2018-01-27 08:00:00,9120,8964,156,7,384,3
2,Testmedium (CCH),2018-01-27 08:00:00,9120,8964,156,7,384,3
2,NovoMix 30 GLY (CCH),2018-01-27 09:00:00,8720,8640,80,57,1164,3
2,NovoMix 30 GLY (CCH),2018-01-27 09:00:00,8720,8640,80,57,1164,3
2,Testmedium (CCH),2018-01-27 09:00:00,8720,8640,80,57,1164,3
2,NovoMix 30 GLY (CCH),2018-01-27 10:00:00,9260,9180,80,39,656,3
2,NovoMix 30 GLY (CCH),2018-01-27 10:00:00,9260,9180,80,39,656,3
2,Testmedium (CCH),2018-01-27 10:00:00,9260,9180,80,39,656,3
2,NovoMix 30 GLY (CCH),2018-01-27 11:00:00,9760,9774,-14,31,29256,3
2,NovoMix 30 GLY (CCH),2018-01-27 11:00:00,9760,9774,-14,31,29256,3
2,Testmedium (CCH),2018-01-27 11:00:00,9760,9774,-14,31,29256,3
2,NovoMix 30 GLY (CCH),2018-01-27 12:00:00,8548,8424,124,1,10,3
2,NovoMix 30 GLY (CCH),2018-01-27 12:00:00,8548,8424,124,1,10,3
2,Testmedium (CCH),2018-01-27 12:00:00,8548,8424,124,1,10,3
2,NovoMix 30 GLY (CCH),2018-01-27 13:00:00,8819,8748,71,57,738,3
2,NovoMix 30 GLY (CCH),2018-01-27 13:00:00,8819,8748,71,57,738,3
2,Testmedium (CCH),2018-01-27 13:00:00,8819,8748,71,57,738,3
2,NovoMix 30 GLY (CCH),2018-01-27 14:00:00,3222,3492,-270,16,2760,3
2,NovoMix 30 GLY (CCH),2018-01-27 14:00:00,3222,3492,-270,16,2760,3
2,Testmedium (CCH),2018-01-27 14:00:00,3222,3492,-270,16,2760,3
2,NovoMix 30 GLY (CCH),2018-01-28 07:00:00,3334,2700,634,28,388,3
2,NovoMix 30 GLY (CCH),2018-01-28 08:00:00,7064,7020,44,39,842,3
2,NovoMix 30 GLY (CCH),2018-01-28 09:00:00,8716,8586,130,71,522,3
2,NovoMix 30 GLY (CCH),2018-01-28 10:00:00,7791,7776,15,54,776,3
2,NovoMix 30 GLY (CCH),2018-01-28 11:00:00,8916,8856,60,42,348,3
2,NovoMix 30 GLY (CCH),2018-01-28 12:00:00,8844,8802,42,54,750,3
2,NovoMix 30 GLY (CCH),2018-01-28 13:00:00,9784,9720,64,47,1406,3
2,NovoMix 30 GLY (CCH),2018-01-28 14:00:00,8752,8748,4,52,392,3
2,NovoMix 30 GLY (CCH),2018-01-28 15:00:00,6840,7020,-180,55,142,3
2,NovoMix 30 GLY (CCH),2018-01-28 16:00:00,9516,9234,282,47,252,3.5
2,NovoMix 30 GLY (CCH),2018-01-28 17:00:00,10440,10368,72,45,262,4
2,NovoMix 30 GLY (CCH),2018-01-28 18:00:00,10412,10368,44,45,198,4
2,NovoMix 30 GLY (CCH),2018-01-28 19:00:00,10147,10044,103,54,178,3.5
2,NovoMix 30 GLY (CCH),2018-01-28 20:00:00,10008,9990,18,44,120,3
2,NovoMix 30 GLY (CCH),2018-01-28 21:00:00,10128,10152,-24,33,614,3
2,NovoMix 30 GLY (CCH),2018-01-28 22:00:00,10072,9990,82,90,834,3
2,NovoMix 30 GLY (CCH),2018-01-28 23:00:00,8560,8424,136,66,1030,3
2,NovoMix 30 GLY (CCH),2018-01-29 00:00:00,8672,8694,-22,94,444,3
2,NovoMix 30 GLY (CCH),2018-01-29 01:00:00,8452,8370,82,93,902,3
2,NovoMix 30 GLY (CCH),2018-01-29 02:00:00,8607,8478,129,48,744,3
2,NovoMix 30 GLY (CCH),2018-01-29 03:00:00,8360,8208,152,46,982,3
2,NovoMix 30 GLY (CCH),2018-01-29 04:00:00,8507,8370,137,66,504,3
2,NovoMix 30 GLY (CCH),2018-01-29 05:00:00,8221,8208,13,65,582,3
2,NovoMix 30 GLY (CCH),2018-01-29 06:00:00,9284,9180,104,50,242,2.33333333333333
2,NovoMix 30 GLY (CCH),2018-01-29 07:00:00,8456,8316,140,43,572,2
2,NovoMix 30 GLY (CCH),2018-01-29 08:00:00,10380,10314,66,48,700,2
2,NovoMix 30 GLY (CCH),2018-01-29 09:00:00,10095,10098,-3,74,526,3
2,NovoMix 30 GLY (CCH),2018-01-29 10:00:00,7972,7920,52,49,1002,4
2,NovoMix 30 GLY (CCH),2018-01-29 11:00:00,9148,9072,76,85,914,4
2,NovoMix 30 GLY (CCH),2018-01-29 12:00:00,7203,7236,-33,75,892,4
2,NovoMix 30 GLY (CCH),2018-01-29 13:00:00,7980,7938,42,2,3680,4
2,NovoMix 30 GLY (CCH),2018-01-29 14:00:00,7789,8244,-455,24,136,4
2,NovoMix 50 NN2000,2018-01-29 15:00:00,474,0,474,29,192,4
2,NovoMix 50 NN2000,2018-01-29 16:00:00,8556,8370,186,44,552,4
2,NovoMix 50 NN2000,2018-01-29 17:00:00,10228,10098,130,51,248,4
2,NovoMix 50 NN2000,2018-01-29 18:00:00,9328,9234,94,39,258,4
2,NovoMix 50 NN2000,2018-01-29 19:00:00,10400,10314,86,54,356,4
2,NovoMix 50 NN2000,2018-01-29 20:00:00,9992,9936,56,49,358,4
2,NovoMix 50 NN2000,2018-01-29 21:00:00,9704,9612,92,15,3596,4
2,NovoMix 50 NN2000,2018-01-29 22:00:00,9902,9774,128,63,302,3.33333333333333
2,NovoMix 50 NN2000,2018-01-29 23:00:00,934,1494,-560,29,8420,3
2,FlexPen Aspart 100 3ML CCH,2018-01-30 00:00:00,7778,7020,758,114,1062,3
2,FlexPen Aspart 100 3ML CCH,2018-01-30 01:00:00,520,756,-236,138,830,3
2,FlexPen Aspart 100 3ML CCH,2018-01-30 03:00:00,4531,4158,373,68,1490,3
2,FlexPen Aspart 100 3ML CCH,2018-01-30 04:00:00,9258,8856,402,120,1126,3
2,FlexPen Aspart 100 3ML CCH,2018-01-30 05:00:00,5758,5508,250,60,490,3
2,FlexPen Aspart 100 3ML CCH,2018-01-30 06:00:00,7746,7614,132,33,144,3
2,FlexPen Aspart 100 3ML CCH,2018-01-30 07:00:00,9804,9504,300,55,484,3
2,FlexPen Aspart 100 3ML CCH,2018-01-30 08:00:00,9584,9558,26,61,830,3
2,FlexPen Aspart 100 3ML CCH,2018-01-30 09:00:00,8924,8856,68,19,54,3
2,FlexPen Aspart 100 3ML CCH,2018-01-30 10:00:00,9984,9936,48,43,488,3.5
2,FlexPen Aspart 100 3ML CCH,2018-01-30 11:00:00,8924,8856,68,88,760,4
2,FlexPen Aspart 100 3ML CCH,2018-01-30 12:00:00,8559,8370,189,26,266,4
2,FlexPen Aspart 100 3ML CCH,2018-01-30 13:00:00,10936,10908,28,83,900,4
2,FlexPen Aspart 100 3ML CCH,2018-01-30 14:00:00,8775,8694,81,25,72,4
2,FlexPen Aspart 100 3ML CCH,2018-01-30 15:00:00,9912,9828,84,32,356,4
2,FlexPen Aspart 100 3ML CCH,2018-01-30 16:00:00,10204,10098,106,51,408,4
2,FlexPen Aspart 100 3ML CCH,2018-01-30 17:00:00,9744,9666,78,25,1520,4
2,FlexPen Aspart 100 3ML CCH,2018-01-30 18:00:00,9532,9396,136,24,2028,4
2,FlexPen Aspart 100 3ML CCH,2018-01-30 19:00:00,8440,8532,-92,25,216,4
2,FlexPen Aspart 100 3ML CCH,2018-01-30 20:00:00,2452,2160,292,40,304,4
2,FlexPen Aspart 100 3ML CCH,2018-01-30 21:00:00,9680,9612,68,44,1284,4
2,FlexPen Aspart 100 3ML CCH,2018-01-30 22:00:00,9732,9666,66,38,370,2.66666666666667
2,FlexPen Aspart 100 3ML CCH,2018-01-30 23:00:00,6832,6624,208,60,1066,2.33333333333333
2,FlexPen Aspart 100 3ML CCH,2018-01-31 00:00:00,9484,9450,34,57,690,2.5
2,FlexPen Aspart 100 3ML CCH,2018-01-31 01:00:00,7800,7668,132,29,3360,2.5
2,FlexPen Aspart 100 3ML CCH,2018-01-31 02:00:00,8408,8316,92,17,5396,2.5
2,FlexPen Aspart 100 3ML CCH,2018-01-31 03:00:00,136,216,-80,23,2156,2.5
2,FlexPen Aspart 100 3ML CCH,2018-01-31 04:00:00,92,54,38,19,3130,2.5
2,FlexPen Aspart 100 3ML CCH,2018-01-31 05:00:00,256,54,202,14,5776,2.5
2,FlexPen Aspart 100 3ML CCH,2018-01-31 06:00:00,348,378,-30,15,660,2.5
2,FlexPen Aspart 100 3ML CCH,2018-01-31 07:00:00,128,54,74,56,810,2.5
2,FlexPen Aspart 100 3ML CCH,2018-01-31 08:00:00,996,702,294,6,2936,2.5
2,FlexPen Aspart 100 3ML CCH,2018-01-31 09:00:00,8156,7938,218,81,1232,2.5
2,FlexPen Aspart 100 3ML CCH,2018-01-31 10:00:00,2391,2376,15,45,556,2.5
2,FlexPen Aspart 100 3ML CCH,2018-01-31 11:00:00,6496,6264,232,62,694,2.5
2,FlexPen Aspart 100 3ML CCH,2018-01-31 12:00:00,9316,9180,136,37,618,2.5
2,FlexPen Aspart 100 3ML CCH,2018-01-31 13:00:00,7555,7398,157,24,412,2.5
2,FlexPen Aspart 100 3ML CCH,2018-01-31 14:00:00,9043,8856,187,42,674,2.5
2,FlexPen Aspart 100 3ML CCH,2018-01-31 15:00:00,9220,9126,94,53,480,2.5
2,FlexPen Aspart 100 3ML CCH,2018-01-31 16:00:00,9292,9126,166,51,304,2.5
2,FlexPen Aspart 100 3ML CCH,2018-01-31 17:00:00,9344,9216,128,58,568,2.5
2,FlexPen Aspart 100 3ML CCH,2018-01-31 18:00:00,9864,9720,144,47,484,2.5
2,FlexPen Aspart 100 3ML CCH,2018-01-31 19:00:00,9348,9234,114,42,386,2.5
2,FlexPen Aspart 100 3ML CCH,2018-01-31 20:00:00,8996,8856,140,55,394,2.5
2,FlexPen Aspart 100 3ML CCH,2018-01-31 21:00:00,9559,9504,55,63,636,2.5
2,FlexPen Aspart 100 3ML CCH,2018-01-31 22:00:00,9524,9396,128,34,368,2.5
2,FlexPen Aspart 100 3ML CCH,2018-01-31 23:00:00,8520,8532,-12,13,2994,2.5
2,FlexPen Aspart 100 3ML CCH,2018-02-01 00:00:00,8954,8856,98,40,564,2.5
2,FlexPen Aspart 100 3ML CCH,2018-02-01 01:00:00,2010,1800,210,41,764,2.5
2,FlexPen Aspart 100 3ML CCH,2018-02-01 01:00:00,2010,1800,210,41,764,2.5
2,FlexPen Aspart 100 3ML CCH,2018-02-01 02:00:00,8588,8694,-106,57,628,2.5
2,FlexPen Aspart 100 3ML CCH,2018-02-01 03:00:00,8315,8316,-1,47,754,2.5
2,FlexPen Aspart 100 3ML CCH,2018-02-01 04:00:00,8356,8370,-14,47,554,2.5
2,FlexPen Aspart 100 3ML CCH,2018-02-01 05:00:00,8672,8478,194,47,430,2.5
2,FlexPen Aspart 100 3ML CCH,2018-02-01 06:00:00,9863,9720,143,78,548,2.5
2,FlexPen Aspart 100 3ML CCH,2018-02-01 07:00:00,8984,8910,74,27,586,2.5
2,FlexPen Aspart 100 3ML CCH,2018-02-01 08:00:00,8632,8532,100,43,4752,2.5
2,FlexPen Aspart 100 3ML CCH,2018-02-01 09:00:00,9228,9234,-6,43,242,2.5
2,FlexPen Aspart 100 3ML CCH,2018-02-01 10:00:00,7508,7668,-160,76,1658,2.5
2,FlexPen Aspart 100 3ML CCH,2018-02-01 11:00:00,92,54,38,44,388,2.5
2,FlexPen Aspart 100 3ML CCH,2018-02-01 12:00:00,8507,8208,299,39,454,2.5
2,FlexPen Aspart 100 3ML CCH,2018-02-01 13:00:00,8948,8964,-16,98,1540,2.5
2,FlexPen Aspart 100 3ML CCH,2018-02-01 14:00:00,8315,8154,161,35,838,2.5
2,FlexPen Aspart 100 3ML CCH,2018-02-01 15:00:00,9615,9558,57,30,354,2.5
2,FlexPen Aspart 100 3ML CCH,2018-02-01 16:00:00,9064,9018,46,40,3026,2.5
2,FlexPen Aspart 100 3ML CCH,2018-02-01 17:00:00,10300,10314,-14,16,272,2.5
2,FlexPen Aspart 100 3ML CCH,2018-02-01 18:00:00,8876,8802,74,34,330,2.5
2,FlexPen Aspart 100 3ML CCH,2018-02-01 19:00:00,8876,8748,128,34,1698,2.5
2,FlexPen Aspart 100 3ML CCH,2018-02-01 20:00:00,9783,9666,117,43,912,2.5
2,FlexPen Aspart 100 3ML CCH,2018-02-01 21:00:00,10000,10206,-206,36,610,2.5
2,FlexPen Aspart 100 3ML CCH,2018-02-01 22:00:00,2099,2052,47,29,488,2.5
2,FlexPen Aspart 100 3ML CCH,2018-02-02 06:00:00,3943,3780,163,16,464,2.5
2,FlexPen Aspart 100 3ML CCH,2018-02-02 07:00:00,5756,5886,-130,33,126,2.5
2,FlexPen Aspart 100 3ML CCH,2018-02-02 08:00:00,1814,1620,194,47,2892,2.5
2,FlexPen Aspart 100 3ML CCH,2018-02-02 09:00:00,9811,9720,91,15,530,2.5
2,FlexPen Aspart 100 3ML CCH,2018-02-02 10:00:00,9644,9558,86,3,1692,2.5
2,FlexPen Aspart 100 3ML CCH,2018-02-02 11:00:00,8644,8802,-158,28,214,2.5
2,FlexPen Aspart 100 3ML CCH,2018-02-02 12:00:00,2474,2268,206,34,602,2.5
2,FlexPen Aspart 100 3ML CCH,2018-02-02 13:00:00,10316,10260,56,52,668,2.5
2,FlexPen Aspart 100 3ML CCH,2018-02-02 14:00:00,9836,9828,8,21,4380,2.5
2,FlexPen Aspart 100 3ML CCH,2018-02-02 15:00:00,8580,8370,210,2,122,2.5
2,FlexPen Aspart 100 3ML CCH,2018-02-02 16:00:00,7316,7236,80,24,228,2.5
2,FlexPen Aspart 100 3ML CCH,2018-02-02 17:00:00,815,918,-103,59,534,2.5
2,FlexPen Aspart 100 3ML CCH,2018-02-02 18:00:00,6088,5994,94,26,156,2.5
2,FlexPen Aspart 100 3ML CCH,2018-02-02 19:00:00,9896,9774,122,49,326,2.5
2,FlexPen Aspart 100 3ML CCH,2018-02-02 20:00:00,9350,9504,-154,45,424,2.5
2,FlexPen Aspart 100 3ML CCH,2018-02-02 21:00:00,9379,9126,253,39,142,2.5
2,FlexPen Aspart 100 3ML CCH,2018-02-02 22:00:00,9010,8910,100,38,522,2.5
2,FlexPen Aspart 100 3ML CCH,2018-02-02 23:00:00,9387,9342,45,51,246,2.5
2,FlexPen Aspart 100 3ML CCH,2018-02-03 00:00:00,9608,9612,-4,97,804,2.5
2,FlexPen Aspart 100 3ML CCH,2018-02-03 01:00:00,10532,10422,110,86,544,2.5
2,FlexPen Aspart 100 3ML CCH,2018-02-03 02:00:00,8972,9018,-46,126,830,2.5
2,FlexPen Aspart 100 3ML CCH,2018-02-03 03:00:00,10212,9990,222,23,1214,2.5
2,FlexPen Aspart 100 3ML CCH,2018-02-03 04:00:00,9320,9126,194,27,266,2.5
2,FlexPen Aspart 100 3ML CCH,2018-02-03 05:00:00,10135,9990,145,37,214,2.5
2,FlexPen Aspart 100 3ML CCH,2018-02-03 06:00:00,9659,9558,101,37,278,2.5
2,FlexPen Aspart 100 3ML CCH,2018-02-03 07:00:00,2810,3330,-520,35,310,2.5
2,FlexPen Aspart 100 3ML CCH,2018-02-03 08:00:00,8162,7398,764,47,1208,2.5
2,FlexPen Aspart 100 3ML CCH,2018-02-03 09:00:00,9559,9396,163,51,318,2.5
2,FlexPen Aspart 100 3ML CCH,2018-02-03 10:00:00,7436,7344,92,47,308,2.5
2,FlexPen Aspart 100 3ML CCH,2018-02-03 11:00:00,2606,3078,-472,106,660,2.5
2,FlexPen Aspart 100 3ML CCH,2018-02-03 12:00:00,6350,5724,626,44,188,2.5
2,FlexPen Aspart 100 3ML CCH,2018-02-03 13:00:00,9875,9774,101,46,522,2.5
2,FlexPen Aspart 100 3ML CCH,2018-02-03 14:00:00,9408,9288,120,44,158,2.5
2,FlexPen Aspart 100 3ML CCH,2018-02-03 15:00:00,9812,9936,-124,31,278,2.5
2,FlexPen Aspart 100 3ML CCH,2018-02-03 16:00:00,9500,9288,212,35,188,2.5
2,FlexPen Aspart 100 3ML CCH,2018-02-03 17:00:00,6820,6750,70,31,278,2.5
2,FlexPen Aspart 100 3ML CCH,2018-02-03 18:00:00,9188,9126,62,35,412,2.5
2,FlexPen Aspart 100 3ML CCH,2018-02-03 19:00:00,10076,9936,140,42,906,2.5
2,FlexPen Aspart 100 3ML CCH,2018-02-03 20:00:00,7649,7560,89,33,3780,2.5
2,FlexPen Aspart 100 3ML CCH,2018-02-03 21:00:00,8676,8640,36,14,254,2.5
2,FlexPen Aspart 100 3ML CCH,2018-02-03 22:00:00,10288,10152,136,37,96,2.5
2,FlexPen Aspart 100 3ML CCH,2018-02-03 23:00:00,9832,9666,166,23,176,2.5
2,FlexPen Aspart 100 3ML CCH,2018-02-04 00:00:00,9476,9342,134,19,452,2.5
2,FlexPen Aspart 100 3ML CCH,2018-02-04 01:00:00,9931,9828,103,39,348,2.5
2,FlexPen Aspart 100 3ML CCH,2018-02-04 02:00:00,9268,9234,34,19,76,2.5
2,FlexPen Aspart 100 3ML CCH,2018-02-04 03:00:00,9748,9612,136,17,1670,2.5
2,FlexPen Aspart 100 3ML CCH,2018-02-04 04:00:00,9261,9072,189,24,262,2.5
2,FlexPen Aspart 100 3ML CCH,2018-02-04 05:00:00,6094,5940,154,25,502,2.5
2,FlexPen Aspart 100 3ML CCH,2018-02-04 06:00:00,6866,6750,116,32,384,2.5
2,FlexPen Aspart 100 3ML CCH,2018-02-04 07:00:00,3765,3618,147,39,2560,2.5
2,FlexPen Aspart 100 3ML CCH,2018-02-04 08:00:00,10524,10422,102,9,412,2.5
2,FlexPen Aspart 100 3ML CCH,2018-02-04 09:00:00,10192,9990,202,50,282,2.5
2,FlexPen Aspart 100 3ML CCH,2018-02-04 10:00:00,9460,9450,10,20,154,2.5
2,FlexPen Aspart 100 3ML CCH,2018-02-04 11:00:00,10500,10368,132,47,394,2.5
2,FlexPen Aspart 100 3ML CCH,2018-02-04 12:00:00,9872,9936,-64,46,564,2.5
2,FlexPen Aspart 100 3ML CCH,2018-02-04 13:00:00,8884,8694,190,35,452,2.5
2,FlexPen Aspart 100 3ML CCH,2018-02-04 14:00:00,8620,8532,88,30,336,2.5
2,FlexPen Aspart 100 3ML CCH,2018-02-04 15:00:00,5706,6210,-504,18,404,2.5
2,FlexPen Aspart 100 3ML CCH,2018-02-04 16:00:00,5834,5238,596,26,126,2.5
2,FlexPen Aspart 100 3ML CCH,2018-02-04 17:00:00,9055,8964,91,41,228,2.5
2,FlexPen Aspart 100 3ML CCH,2018-02-04 18:00:00,9195,9126,69,12,120,2.5
2,FlexPen Aspart 100 3ML CCH,2018-02-04 19:00:00,7900,7830,70,23,418,2.5
2,FlexPen Aspart 100 3ML CCH,2018-02-04 20:00:00,10028,10044,-16,47,340,2.5
2,FlexPen Aspart 100 3ML CCH,2018-02-04 21:00:00,9906,9720,186,90,410,2.5
2,FlexPen Aspart 100 3ML CCH,2018-02-04 22:00:00,10583,10530,53,30,516,2.5
2,FlexPen Aspart 100 3ML CCH,2018-02-04 23:00:00,10076,9990,86,15,172,2.5
2,FlexPen Aspart 100 3ML CCH,2018-02-05 00:00:00,9788,9774,14,19,160,2.5
2,FlexPen Aspart 100 3ML CCH,2018-02-05 01:00:00,9388,9288,100,20,444,2.5
2,FlexPen Aspart 100 3ML CCH,2018-02-05 02:00:00,9916,9882,34,57,230,2.5
2,FlexPen Aspart 100 3ML CCH,2018-02-05 03:00:00,9936,9828,108,23,112,2.5
2,FlexPen Aspart 100 3ML CCH,2018-02-05 04:00:00,9588,9558,30,35,518,2.5
2,FlexPen Aspart 100 3ML CCH,2018-02-05 05:00:00,9920,9828,92,13,2274,2.5
2,FlexPen Aspart 100 3ML CCH,2018-02-05 06:00:00,10172,10098,74,30,3782,2.5
2,FlexPen Aspart 100 3ML CCH,2018-02-05 07:00:00,7580,7506,74,28,3092,2.5
2,FlexPen Aspart 100 3ML CCH,2018-02-05 08:00:00,5791,5724,67,25,220,2.5
2,FlexPen Aspart 100 3ML CCH,2018-02-05 09:00:00,8643,8532,111,15,370,2.5
2,FlexPen Aspart 100 3ML CCH,2018-02-05 10:00:00,8672,8532,140,75,508,2.5
2,FlexPen Aspart 100 3ML CCH,2018-02-05 11:00:00,10359,10260,99,14,390,2.5
2,FlexPen Aspart 100 3ML CCH,2018-02-05 12:00:00,8334,8424,-90,13,1954,2.5
2,FlexPen Aspart 100 3ML CCH,2018-02-05 13:00:00,170,612,-442,9,2126,2.5
2,FlexPen Aspart 100 3ML CCH,2018-02-05 14:00:00,6501,5832,669,16,2232,2.5
2,FlexPen Aspart 100 3ML CCH,2018-02-05 15:00:00,6940,6804,136,32,510,2.5
2,FlexPen Aspart 100 3ML CCH,2018-02-05 16:00:00,9380,9342,38,38,1166,2.5
2,FlexPen Aspart 100 3ML CCH,2018-02-05 17:00:00,9132,8910,222,121,562,2.5
2,FlexPen Aspart 100 3ML CCH,2018-02-05 18:00:00,10252,10152,100,89,1676,2.5
2,FlexPen Aspart 100 3ML CCH,2018-02-05 19:00:00,2550,2430,120,101,938,2.5
2,NovoMix 30 GLY (CCH),2018-02-05 19:00:00,2550,2430,120,101,938,2.5
2,NovoMix 30 GLY (CCH),2018-02-05 20:00:00,10436,10422,14,35,206,2.5
2,NovoMix 30 GLY (CCH),2018-02-05 21:00:00,9435,9342,93,88,666,2.5
2,NovoMix 30 GLY (CCH),2018-02-05 22:00:00,9680,9666,14,56,296,2.5
2,NovoMix 30 GLY (CCH),2018-02-05 23:00:00,10234,10260,-26,54,374,2.5
2,NovoMix 30 GLY (CCH),2018-02-06 00:00:00,9804,9666,138,36,2176,2.5
2,NovoMix 30 GLY (CCH),2018-02-06 01:00:00,8844,8910,-66,62,1136,2.5
2,NovoMix 30 GLY (CCH),2018-02-06 02:00:00,8748,8748,0,82,634,2.5
2,NovoMix 30 GLY (CCH),2018-02-06 03:00:00,5172,4914,258,74,404,2.5
2,NovoMix 30 GLY (CCH),2018-02-06 04:00:00,9984,9882,102,31,676,2.5
2,NovoMix 30 GLY (CCH),2018-02-06 05:00:00,9342,9288,54,42,598,2.5
2,NovoMix 30 GLY (CCH),2018-02-06 06:00:00,9412,9396,16,6,3686,2.5
2,NovoMix 30 GLY (CCH),2018-02-06 07:00:00,10532,10422,110,30,984,2.5
2,NovoMix 30 GLY (CCH),2018-02-06 08:00:00,7028,7020,8,22,872,2.5
2,NovoMix 30 GLY (CCH),2018-02-06 09:00:00,8908,8802,106,23,390,2.5
2,NovoMix 30 GLY (CCH),2018-02-06 10:00:00,9500,9450,50,50,1454,2.5
2,NovoMix 30 GLY (CCH),2018-02-06 11:00:00,7376,7344,32,21,4764,2.5
2,NovoMix 30 GLY (CCH),2018-02-06 12:00:00,9424,9504,-80,16,148,2.5
2,NovoMix 30 GLY (CCH),2018-02-06 13:00:00,8212,7992,220,19,232,2.5
2,NovoMix 30 GLY (CCH),2018-02-06 14:00:00,8144,7938,206,41,698,2.5
2,NovoMix 30 GLY (CCH),2018-02-06 15:00:00,9240,9180,60,31,620,2.5
2,NovoMix 30 GLY (CCH),2018-02-06 16:00:00,10296,10206,90,28,226,3
2,NovoMix 30 GLY (CCH),2018-02-06 17:00:00,9092,9126,-34,66,312,4
2,NovoMix 30 GLY (CCH),2018-02-06 18:00:00,10096,9990,106,21,3388,4
2,NovoMix 30 GLY (CCH),2018-02-06 19:00:00,9616,9504,112,1,4058,4
2,NovoMix 30 GLY (CCH),2018-02-06 20:00:00,10098,10098,0,46,364,4
2,NovoMix 30 GLY (CCH),2018-02-06 21:00:00,10296,10206,90,31,3728,4
2,NovoMix 30 GLY (CCH),2018-02-06 22:00:00,10158,10044,114,12,1296,4
2,NovoMix 30 GLY (CCH),2018-02-06 23:00:00,10100,10044,56,43,1056,4
2,NovoMix 30 GLY (CCH),2018-02-07 00:00:00,9970,9990,-20,38,216,4
2,NovoMix 30 GLY (CCH),2018-02-07 01:00:00,9224,9000,224,39,220,4
2,NovoMix 30 GLY (CCH),2018-02-07 02:00:00,9912,9828,84,72,712,4
2,NovoMix 30 GLY (CCH),2018-02-07 03:00:00,7454,7956,-502,93,540,4
2,Protaphan (CCH),2018-02-07 04:00:00,402,0,402,77,482,4
2,Protaphan (CCH),2018-02-07 05:00:00,5446,5076,370,55,1200,4
2,Protaphan (CCH),2018-02-07 06:00:00,7496,7344,152,55,468,4
2,Protaphan (CCH),2018-02-07 07:00:00,6035,6462,-427,12,6512,4
2,FlexPen Aspart 100 3ML CCH,2018-02-07 08:00:00,1630,1026,604,67,312,4
2,FlexPen Aspart 100 3ML CCH,2018-02-07 09:00:00,9095,9018,77,84,236,4
2,FlexPen Aspart 100 3ML CCH,2018-02-07 10:00:00,9816,9666,150,126,366,4
2,FlexPen Aspart 100 3ML CCH,2018-02-07 11:00:00,9158,9126,32,114,378,4
2,FlexPen Aspart 100 3ML CCH,2018-02-07 12:00:00,10051,9936,115,119,386,4
2,FlexPen Aspart 100 3ML CCH,2018-02-07 13:00:00,9560,9450,110,72,1944,4
2,FlexPen Aspart 100 3ML CCH,2018-02-07 14:00:00,9724,9612,112,44,1192,4
2,FlexPen Aspart 100 3ML CCH,2018-02-07 15:00:00,6392,6318,74,52,726,4
2,FlexPen Aspart 100 3ML CCH,2018-02-07 16:00:00,6000,5994,6,21,2176,4
2,FlexPen Aspart 100 3ML CCH,2018-02-07 17:00:00,8531,8316,215,42,1206,4
2,FlexPen Aspart 100 3ML CCH,2018-02-07 18:00:00,4844,4806,38,7,5408,4
2,FlexPen Aspart 100 3ML CCH,2018-02-07 19:00:00,6896,6750,146,4,1234,4
2,FlexPen Aspart 100 3ML CCH,2018-02-07 20:00:00,3387,3456,-69,48,438,4
2,FlexPen Aspart 100 3ML CCH,2018-02-07 21:00:00,219,108,111,62,314,4
2,FlexPen Aspart 100 3ML CCH,2018-02-07 22:00:00,7959,7776,183,45,640,4
2,FlexPen Aspart 100 3ML CCH,2018-02-07 23:00:00,9935,9882,53,98,534,4
2,FlexPen Aspart 100 3ML CCH,2018-02-08 00:00:00,9233,9072,161,59,562,4
2,FlexPen Aspart 100 3ML CCH,2018-02-08 01:00:00,8816,8640,176,82,286,4
2,FlexPen Aspart 100 3ML CCH,2018-02-08 02:00:00,8150,7992,158,36,2360,4
2,FlexPen Aspart 100 3ML CCH,2018-02-08 03:00:00,10264,10206,58,94,656,4
2,FlexPen Aspart 100 3ML CCH,2018-02-08 04:00:00,3850,3834,16,80,644,4
2,FlexPen Aspart 100 3ML CCH,2018-02-08 05:00:00,8880,8964,-84,89,668,4
2,FlexPen Aspart 100 3ML CCH,2018-02-08 06:00:00,8936,8748,188,106,548,4
2,FlexPen Aspart 100 3ML CCH,2018-02-08 07:00:00,9011,8964,47,95,1372,4
2,FlexPen Aspart 100 3ML CCH,2018-02-08 08:00:00,9256,9288,-32,74,946,4
2,FlexPen Aspart 100 3ML CCH,2018-02-08 09:00:00,7654,7668,-14,59,1932,4
2,FlexPen Aspart 100 3ML CCH,2018-02-08 10:00:00,7056,6858,198,84,764,4
2,FlexPen Aspart 100 3ML CCH,2018-02-08 11:00:00,7448,7344,104,111,956,4
2,FlexPen Aspart 100 3ML CCH,2018-02-08 12:00:00,6439,6534,-95,41,2284,4
2,FlexPen Aspart 100 3ML CCH,2018-02-08 13:00:00,7956,7884,72,100,480,4
2,FlexPen Aspart 100 3ML CCH,2018-02-08 14:00:00,3720,3564,156,103,808,4
2,FlexPen Aspart 100 3ML CCH,2018-02-08 15:00:00,9358,9342,16,46,1232,4
2,FlexPen Aspart 100 3ML CCH,2018-02-08 16:00:00,8371,8316,55,22,5446,4
2,FlexPen Aspart 100 3ML CCH,2018-02-08 17:00:00,7287,7236,51,8,134,4
2,FlexPen Aspart 100 3ML CCH,2018-02-08 18:00:00,2010,2574,-564,51,272,4
2,Detemir Gly (CCH),2018-02-08 19:00:00,2614,2106,508,64,304,4
2,Detemir Gly (CCH),2018-02-08 20:00:00,10056,9882,174,65,4974,4
2,Detemir Gly (CCH),2018-02-08 21:00:00,10152,10098,54,29,906,4
2,Detemir Gly (CCH),2018-02-08 22:00:00,1391,1512,-121,51,342,4
2,Detemir Gly (CCH),2018-02-08 23:00:00,3297,3078,219,61,650,4
2,Detemir Gly (CCH),2018-02-09 00:00:00,9232,9180,52,47,550,4
2,Detemir Gly (CCH),2018-02-09 01:00:00,8605,8532,73,49,182,3.5
2,Detemir Gly (CCH),2018-02-09 02:00:00,9432,9450,-18,63,438,3.5
2,Detemir Gly (CCH),2018-02-09 03:00:00,10556,10476,80,38,266,3.5
2,Detemir Gly (CCH),2018-02-09 04:00:00,9431,9288,143,13,6730,3.5
2,Detemir Gly (CCH),2018-02-09 05:00:00,7112,7128,-16,6,156,3.5
2,Detemir Gly (CCH),2018-02-09 06:00:00,0,54,-54,5,92,3.5
2,Detemir Gly (CCH),2018-02-09 08:00:00,196,162,34,65,450,3.5
2,Detemir Gly (CCH),2018-02-09 10:00:00,1048,1026,22,75,562,3.5
2,Detemir Gly (CCH),2018-02-09 11:00:00,8524,8478,46,53,458,3.5
2,Detemir Gly (CCH),2018-02-09 12:00:00,3668,3672,-4,50,824,3.5
2,Detemir Gly (CCH),2018-02-09 13:00:00,7335,7236,99,46,564,3.5
2,Detemir Gly (CCH),2018-02-09 14:00:00,7256,7182,74,18,5160,3.5
2,Detemir Gly (CCH),2018-02-09 15:00:00,6192,6102,90,12,160,3.5
2,Detemir Gly (CCH),2018-02-09 16:00:00,9464,9558,-94,65,344,3.5
2,Detemir Gly (CCH),2018-02-09 17:00:00,9132,8964,168,66,238,3.5
2,Detemir Gly (CCH),2018-02-09 18:00:00,8576,8640,-64,76,188,3.5
2,Detemir Gly (CCH),2018-02-09 19:00:00,8800,8640,160,92,438,3.5
2,Detemir Gly (CCH),2018-02-09 20:00:00,8599,8586,13,111,486,3.5
2,Detemir Gly (CCH),2018-02-09 21:00:00,9545,9504,41,95,452,3.5
2,Detemir Gly (CCH),2018-02-09 22:00:00,9247,9126,121,114,304,3.5
2,Detemir Gly (CCH),2018-02-09 23:00:00,9564,9558,6,107,504,3.5
2,Detemir Gly (CCH),2018-02-10 00:00:00,8607,8532,75,141,642,3.5
2,Detemir Gly (CCH),2018-02-10 01:00:00,8976,8910,66,63,2538,3.5
2,Detemir Gly (CCH),2018-02-10 02:00:00,8768,8802,-34,63,878,3.5
2,Detemir Gly (CCH),2018-02-10 03:00:00,9368,9234,134,113,418,3.5
2,Detemir Gly (CCH),2018-02-10 04:00:00,8832,8802,30,123,348,3.5
2,Detemir Gly (CCH),2018-02-10 05:00:00,9004,9018,-14,112,360,3.5
2,Detemir Gly (CCH),2018-02-10 06:00:00,196,612,-416,78,424,3.5
2,Aspart (CHH),2018-02-10 07:00:00,4616,4104,512,108,696,3.5
2,Aspart (CHH),2018-02-10 08:00:00,9276,9126,150,109,322,3.5
2,Aspart (CHH),2018-02-10 09:00:00,8496,8424,72,81,1534,3.5
2,Aspart (CHH),2018-02-10 10:00:00,9000,8910,90,88,218,3.5
2,Aspart (CHH),2018-02-10 11:00:00,9940,9828,112,98,816,3.5
2,Aspart (CHH),2018-02-10 12:00:00,9248,9126,122,72,874,3.5
2,Aspart (CHH),2018-02-10 13:00:00,8140,8154,-14,92,566,3.5
2,Aspart (CHH),2018-02-10 14:00:00,9520,9342,178,104,976,3.5
2,Aspart (CHH),2018-02-10 15:00:00,8780,8748,32,76,770,3.5
2,Aspart (CHH),2018-02-10 16:00:00,9382,9288,94,98,470,3.5
2,Aspart (CHH),2018-02-10 17:00:00,9068,9018,50,95,698,3.5
2,Aspart (CHH),2018-02-10 18:00:00,8834,8694,140,125,460,3.5
2,Aspart (CHH),2018-02-10 19:00:00,5018,5562,-544,125,816,3.5
2,FlexPen Aspart 100 3ML CCH,2018-02-10 20:00:00,7064,6534,530,135,384,3.5
2,FlexPen Aspart 100 3ML CCH,2018-02-10 21:00:00,8148,7938,210,153,520,3.5
2,FlexPen Aspart 100 3ML CCH,2018-02-10 22:00:00,9768,9774,-6,193,508,3.5
2,FlexPen Aspart 100 3ML CCH,2018-02-10 23:00:00,9100,9018,82,150,444,3.5
2,FlexPen Aspart 100 3ML CCH,2018-02-11 00:00:00,9448,9396,52,159,496,3.5
2,FlexPen Aspart 100 3ML CCH,2018-02-11 01:00:00,9759,9612,147,79,526,3.5
2,FlexPen Aspart 100 3ML CCH,2018-02-11 02:00:00,9660,9612,48,69,458,3.5
2,FlexPen Aspart 100 3ML CCH,2018-02-11 03:00:00,9608,9558,50,96,460,3.5
2,FlexPen Aspart 100 3ML CCH,2018-02-11 04:00:00,9836,9720,116,95,422,3.5
2,FlexPen Aspart 100 3ML CCH,2018-02-11 05:00:00,9863,9828,35,99,474,3.5
2,FlexPen Aspart 100 3ML CCH,2018-02-11 06:00:00,10159,10044,115,96,338,3.5
2,FlexPen Aspart 100 3ML CCH,2018-02-11 07:00:00,9177,9126,51,115,368,3.5
2,FlexPen Aspart 100 3ML CCH,2018-02-11 08:00:00,9480,9342,138,81,1008,3.5
2,FlexPen Aspart 100 3ML CCH,2018-02-11 09:00:00,9339,9342,-3,107,686,3.5
2,FlexPen Aspart 100 3ML CCH,2018-02-11 10:00:00,7788,7614,174,84,570,3.5
2,FlexPen Aspart 100 3ML CCH,2018-02-11 11:00:00,9482,9396,86,112,866,3.5
2,FlexPen Aspart 100 3ML CCH,2018-02-11 12:00:00,9700,9666,34,47,2516,3.5
2,FlexPen Aspart 100 3ML CCH,2018-02-11 13:00:00,8576,8478,98,24,534,3.5
2,FlexPen Aspart 100 3ML CCH,2018-02-11 14:00:00,5180,4788,392,53,498,3.5
2,FlexPen Aspart 100 3ML CCH,2018-02-11 15:00:00,9764,9720,44,78,1170,3.5
2,FlexPen Aspart 100 3ML CCH,2018-02-11 16:00:00,9592,9504,88,72,600,3.5
2,FlexPen Aspart 100 3ML CCH,2018-02-11 17:00:00,9386,9342,44,115,288,3.5
2,FlexPen Aspart 100 3ML CCH,2018-02-11 18:00:00,9056,9072,-16,127,550,3.5
2,FlexPen Aspart 100 3ML CCH,2018-02-11 19:00:00,7686,8046,-360,110,530,3.5
2,FlexPen Aspart 100 3ML CCH,2018-02-11 20:00:00,2782,2214,568,101,730,3.5
2,FlexPen Aspart 100 3ML CCH,2018-02-11 21:00:00,9388,9342,46,94,1142,3.5
2,FlexPen Aspart 100 3ML CCH,2018-02-11 22:00:00,9940,9828,112,62,570,3.5
2,FlexPen Aspart 100 3ML CCH,2018-02-11 23:00:00,8488,8424,64,93,526,3.5
2,FlexPen Aspart 100 3ML CCH,2018-02-12 00:00:00,9440,9450,-10,111,818,3.5
2,FlexPen Aspart 100 3ML CCH,2018-02-12 01:00:00,8928,8856,72,75,420,3.5
2,FlexPen Aspart 100 3ML CCH,2018-02-12 02:00:00,9616,9450,166,58,1112,3.5
2,FlexPen Aspart 100 3ML CCH,2018-02-12 03:00:00,9744,9720,24,69,5006,3.5
2,FlexPen Aspart 100 3ML CCH,2018-02-12 04:00:00,8012,7938,74,65,318,3.5
2,FlexPen Aspart 100 3ML CCH,2018-02-12 05:00:00,8460,8424,36,46,480,3.5
2,FlexPen Aspart 100 3ML CCH,2018-02-12 06:00:00,9316,9126,190,1,7634,3.5
2,FlexPen Aspart 100 3ML CCH,2018-02-12 07:00:00,9960,9882,78,27,396,3.33333333333333
2,FlexPen Aspart 100 3ML CCH,2018-02-12 08:00:00,9084,9072,12,49,288,4
2,FlexPen Aspart 100 3ML CCH,2018-02-12 09:00:00,3532,3726,-194,79,478,4
2,FlexPen Aspart 100 3ML CCH,2018-02-12 11:00:00,8284,8046,238,88,574,4
2,FlexPen Aspart 100 3ML CCH,2018-02-12 12:00:00,10288,10260,28,68,972,4
2,FlexPen Aspart 100 3ML CCH,2018-02-12 13:00:00,9848,9720,128,46,310,4
2,FlexPen Aspart 100 3ML CCH,2018-02-12 14:00:00,9764,9828,-64,50,372,4
2,FlexPen Aspart 100 3ML CCH,2018-02-12 15:00:00,8806,8586,220,60,508,3.66666666666667
2,FlexPen Aspart 100 3ML CCH,2018-02-12 16:00:00,8026,7992,34,43,1046,3
2,FlexPen Aspart 100 3ML CCH,2018-02-12 17:00:00,10154,10098,56,80,752,3
2,FlexPen Aspart 100 3ML CCH,2018-02-12 18:00:00,9984,10044,-60,54,212,3
2,FlexPen Aspart 100 3ML CCH,2018-02-12 19:00:00,9568,9396,172,45,1114,3
2,FlexPen Aspart 100 3ML CCH,2018-02-12 20:00:00,7552,7452,100,83,438,3
2,FlexPen Aspart 100 3ML CCH,2018-02-12 21:00:00,8808,8640,168,46,504,3
2,FlexPen Aspart 100 3ML CCH,2018-02-12 22:00:00,9600,9504,96,65,552,3
2,FlexPen Aspart 100 3ML CCH,2018-02-12 23:00:00,7216,7128,88,77,462,3
2,FlexPen Aspart 100 3ML CCH,2018-02-13 00:00:00,9456,9342,114,26,7830,3
2,FlexPen Aspart 100 3ML CCH,2018-02-13 01:00:00,8736,8694,42,59,1162,3
2,FlexPen Aspart 100 3ML CCH,2018-02-13 02:00:00,9418,9342,76,80,506,3
2,FlexPen Aspart 100 3ML CCH,2018-02-13 03:00:00,9466,9234,232,71,1138,3
2,FlexPen Aspart 100 3ML CCH,2018-02-13 04:00:00,1722,2286,-564,5,3950,3
2,FlexPen Aspart 100 3ML CCH,2018-02-13 07:00:00,4656,4050,606,42,510,3
2,FlexPen Aspart 100 3ML CCH,2018-02-13 08:00:00,8800,8640,160,47,278,3
2,FlexPen Aspart 100 3ML CCH,2018-02-13 09:00:00,10268,10206,62,37,850,3
2,FlexPen Aspart 100 3ML CCH,2018-02-13 10:00:00,8860,8694,166,30,440,3
2,FlexPen Aspart 100 3ML CCH,2018-02-13 11:00:00,9539,9450,89,42,270,3
2,FlexPen Aspart 100 3ML CCH,2018-02-13 12:00:00,10144,9936,208,34,334,3
2,FlexPen Aspart 100 3ML CCH,2018-02-13 13:00:00,8884,8802,82,46,894,3
2,FlexPen Aspart 100 3ML CCH,2018-02-13 14:00:00,2878,3420,-542,32,958,3
2,FlexPen Aspart 100 3ML CCH,2018-02-13 15:00:00,7598,6966,632,46,660,3
2,FlexPen Aspart 100 3ML CCH,2018-02-13 16:00:00,9892,9882,10,54,344,3
2,FlexPen Aspart 100 3ML CCH,2018-02-13 17:00:00,9743,9594,149,31,324,3
2,FlexPen Aspart 100 3ML CCH,2018-02-13 18:00:00,8160,8100,60,61,796,3
2,FlexPen Aspart 100 3ML CCH,2018-02-13 19:00:00,9408,9288,120,44,780,3
2,FlexPen Aspart 100 3ML CCH,2018-02-13 20:00:00,9900,9720,180,61,362,3
2,FlexPen Aspart 100 3ML CCH,2018-02-13 21:00:00,9847,9720,127,39,1012,3
2,FlexPen Aspart 100 3ML CCH,2018-02-13 22:00:00,8624,8640,-16,33,346,3
2,FlexPen Aspart 100 3ML CCH,2018-02-13 23:00:00,9076,8964,112,23,744,3
2,FlexPen Aspart 100 3ML CCH,2018-02-14 00:00:00,9560,9450,110,53,766,3
2,FlexPen Aspart 100 3ML CCH,2018-02-14 01:00:00,8524,8478,46,47,9894,3
2,FlexPen Aspart 100 3ML CCH,2018-02-14 02:00:00,1927,1836,91,10,31168,3
2,FlexPen Aspart 100 3ML CCH,2018-02-14 02:00:00,1927,1836,91,10,31168,3
2,FlexPen Aspart 100 3ML CCH,2018-02-14 03:00:00,8180,8154,26,31,232,3
2,FlexPen Aspart 100 3ML CCH,2018-02-14 04:00:00,8224,8154,70,49,588,3
2,FlexPen Aspart 100 3ML CCH,2018-02-14 05:00:00,10104,9936,168,58,654,3
2,FlexPen Aspart 100 3ML CCH,2018-02-14 06:00:00,2944,3078,-134,7,142,3
2,FlexPen Aspart 100 3ML CCH,2018-02-14 14:00:00,60,162,-102,52,406,3
2,FlexPen Aspart 100 3ML CCH,2018-02-14 15:00:00,3612,3402,210,66,300,2.66666666666667
2,FlexPen Aspart 100 3ML CCH,2018-02-14 16:00:00,6580,6534,46,47,270,2
2,FlexPen Aspart 100 3ML CCH,2018-02-14 17:00:00,4576,4482,94,25,1602,2
2,FlexPen Aspart 100 3ML CCH,2018-02-14 18:00:00,9075,8748,327,1,3290,2
2,FlexPen Aspart 100 3ML CCH,2018-02-14 19:00:00,9972,9828,144,2,154,2
2,FlexPen Aspart 100 3ML CCH,2018-02-14 20:00:00,10144,10044,100,39,598,2
2,FlexPen Aspart 100 3ML CCH,2018-02-14 21:00:00,5520,5454,66,70,556,2
2,FlexPen Aspart 100 3ML CCH,2018-02-14 22:00:00,9980,9882,98,56,3310,2
2,FlexPen Aspart 100 3ML CCH,2018-02-14 23:00:00,8452,8424,28,35,2896,2
2,FlexPen Aspart 100 3ML CCH,2018-02-15 00:00:00,9256,9126,130,41,794,2
2,FlexPen Aspart 100 3ML CCH,2018-02-15 01:00:00,5472,5400,72,91,896,2.5
2,FlexPen Aspart 100 3ML CCH,2018-02-15 02:00:00,2878,3222,-344,57,510,2.5
2,FlexPen Aspart 100 3ML CCH,2018-02-15 03:00:00,7632,7020,612,70,906,2.5
2,FlexPen Aspart 100 3ML CCH,2018-02-15 04:00:00,5092,5184,-92,140,446,2.5
2,FlexPen Aspart 100 3ML CCH,2018-02-15 05:00:00,5428,5346,82,78,652,2.5
2,FlexPen Aspart 100 3ML CCH,2018-02-15 06:00:00,7000,6804,196,32,932,2.5
2,FlexPen Aspart 100 3ML CCH,2018-02-15 07:00:00,2380,2214,166,1,7076,2.5
2,FlexPen Aspart 100 3ML CCH,2018-02-15 08:00:00,7936,7830,106,64,574,2.5
2,FlexPen Aspart 100 3ML CCH,2018-02-15 09:00:00,9332,9234,98,72,326,2.5
2,FlexPen Aspart 100 3ML CCH,2018-02-15 10:00:00,9159,9072,87,74,374,2.5
2,FlexPen Aspart 100 3ML CCH,2018-02-15 11:00:00,4756,4698,58,53,532,2.5
2,FlexPen Aspart 100 3ML CCH,2018-02-15 12:00:00,8944,8856,88,30,178,2.5
2,FlexPen Aspart 100 3ML CCH,2018-02-15 13:00:00,10208,10152,56,27,200,2.5
2,FlexPen Aspart 100 3ML CCH,2018-02-15 14:00:00,9728,9612,116,62,294,2.5
2,FlexPen Aspart 100 3ML CCH,2018-02-15 15:00:00,10420,10314,106,37,766,2.5
2,FlexPen Aspart 100 3ML CCH,2018-02-15 16:00:00,9812,9774,38,47,712,2.5
2,FlexPen Aspart 100 3ML CCH,2018-02-15 17:00:00,9952,9828,124,50,408,2.5
2,FlexPen Aspart 100 3ML CCH,2018-02-15 18:00:00,10040,10044,-4,47,448,2.5
2,FlexPen Aspart 100 3ML CCH,2018-02-15 19:00:00,10107,9936,171,24,304,2.5
2,FlexPen Aspart 100 3ML CCH,2018-02-15 20:00:00,10368,10314,54,43,134,2.5
2,FlexPen Aspart 100 3ML CCH,2018-02-15 21:00:00,10108,10044,64,42,486,2.5
2,FlexPen Aspart 100 3ML CCH,2018-02-15 22:00:00,9587,9504,83,36,290,2.5
2,FlexPen Aspart 100 3ML CCH,2018-02-15 23:00:00,9004,8910,94,55,226,2
2,FlexPen Aspart 100 3ML CCH,2018-02-16 00:00:00,3348,3348,0,38,242,2.5
2,FlexPen Aspart 100 3ML CCH,2018-02-16 01:00:00,8576,8586,-10,25,446,3
2,FlexPen Aspart 100 3ML CCH,2018-02-16 02:00:00,6010,6462,-452,42,246,3
2,FlexPen Aspart 100 3ML CCH,2018-02-16 03:00:00,3590,3186,404,20,8906,3
2,FlexPen Aspart 100 3ML CCH,2018-02-16 04:00:00,9701,9504,197,84,982,3
2,FlexPen Aspart 100 3ML CCH,2018-02-16 05:00:00,7088,7182,-94,125,532,3
2,FlexPen Aspart 100 3ML CCH,2018-02-16 06:00:00,8831,8586,245,124,342,3
2,FlexPen Aspart 100 3ML CCH,2018-02-16 07:00:00,9785,9720,65,141,350,3
2,FlexPen Aspart 100 3ML CCH,2018-02-16 08:00:00,7972,7938,34,67,502,3
2,FlexPen Aspart 100 3ML CCH,2018-02-16 09:00:00,9348,9288,60,37,618,3
2,FlexPen Aspart 100 3ML CCH,2018-02-16 10:00:00,9952,9882,70,45,296,3
2,FlexPen Aspart 100 3ML CCH,2018-02-16 11:00:00,9856,9828,28,49,464,3
2,FlexPen Aspart 100 3ML CCH,2018-02-16 12:00:00,8336,8316,20,50,352,3
2,FlexPen Aspart 100 3ML CCH,2018-02-16 13:00:00,9571,9504,67,42,478,3
2,FlexPen Aspart 100 3ML CCH,2018-02-16 14:00:00,9376,9342,34,23,120,3
2,FlexPen Aspart 100 3ML CCH,2018-02-16 15:00:00,9648,9612,36,48,412,3
2,FlexPen Aspart 100 3ML CCH,2018-02-16 16:00:00,10136,10044,92,34,364,3
2,FlexPen Aspart 100 3ML CCH,2018-02-16 17:00:00,10208,10206,2,29,1876,3
2,FlexPen Aspart 100 3ML CCH,2018-02-16 18:00:00,10448,10368,80,34,1616,3
2,FlexPen Aspart 100 3ML CCH,2018-02-16 19:00:00,9784,9666,118,24,2084,3
2,FlexPen Aspart 100 3ML CCH,2018-02-16 20:00:00,9276,9234,42,59,438,3
2,FlexPen Aspart 100 3ML CCH,2018-02-16 21:00:00,9104,9072,32,47,634,3
2,FlexPen Aspart 100 3ML CCH,2018-02-16 22:00:00,9076,9018,58,76,244,3
2,FlexPen Aspart 100 3ML CCH,2018-02-16 23:00:00,9471,9396,75,112,668,3
2,FlexPen Aspart 100 3ML CCH,2018-02-17 00:00:00,7831,7776,55,121,336,3.5
2,FlexPen Aspart 100 3ML CCH,2018-02-17 01:00:00,8604,8640,-36,120,634,3.5
2,FlexPen Aspart 100 3ML CCH,2018-02-17 02:00:00,6112,5994,118,132,822,3.5
2,FlexPen Aspart 100 3ML CCH,2018-02-17 03:00:00,8286,8262,24,78,1882,3.5
2,FlexPen Aspart 100 3ML CCH,2018-02-17 04:00:00,7836,7776,60,97,374,3.5
2,FlexPen Aspart 100 3ML CCH,2018-02-17 05:00:00,8160,8100,60,24,2168,3.5
2,FlexPen Aspart 100 3ML CCH,2018-02-17 06:00:00,8651,9180,-529,30,818,3.5
2,FlexPen Aspart 100 3ML CCH,2018-02-17 07:00:00,3706,3078,628,52,422,3.5
2,FlexPen Aspart 100 3ML CCH,2018-02-17 08:00:00,8663,8640,23,67,608,3.5
2,FlexPen Aspart 100 3ML CCH,2018-02-17 09:00:00,5528,5454,74,54,340,3.5
2,FlexPen Aspart 100 3ML CCH,2018-02-17 10:00:00,4792,4806,-14,49,432,3.5
2,FlexPen Aspart 100 3ML CCH,2018-02-17 11:00:00,8592,8586,6,65,434,3.5
2,FlexPen Aspart 100 3ML CCH,2018-02-17 12:00:00,8852,8694,158,62,518,3.5
2,FlexPen Aspart 100 3ML CCH,2018-02-17 13:00:00,9376,9342,34,42,826,3.5
2,FlexPen Aspart 100 3ML CCH,2018-02-17 14:00:00,7656,7560,96,54,466,3.5
2,FlexPen Aspart 100 3ML CCH,2018-02-17 15:00:00,8696,8856,-160,50,422,3.5
2,FlexPen Aspart 100 3ML CCH,2018-02-17 16:00:00,8719,8532,187,37,372,3.5
2,FlexPen Aspart 100 3ML CCH,2018-02-17 17:00:00,8664,8532,132,66,388,3.5
2,FlexPen Aspart 100 3ML CCH,2018-02-17 18:00:00,9424,9396,28,57,502,3.5
2,FlexPen Aspart 100 3ML CCH,2018-02-17 19:00:00,7908,7830,78,48,210,3.5
2,FlexPen Aspart 100 3ML CCH,2018-02-17 20:00:00,9564,9504,60,42,232,3.5
2,FlexPen Aspart 100 3ML CCH,2018-02-17 21:00:00,8556,8748,-192,54,472,3.5
2,FlexPen Aspart 100 3ML CCH,2018-02-17 22:00:00,8312,8100,212,53,240,3
2,FlexPen Aspart 100 3ML CCH,2018-02-17 23:00:00,8816,8694,122,38,952,3.33333333333333
2,FlexPen Aspart 100 3ML CCH,2018-02-18 00:00:00,9244,9180,64,48,226,4
2,FlexPen Aspart 100 3ML CCH,2018-02-18 01:00:00,9368,9288,80,51,436,4
2,FlexPen Aspart 100 3ML CCH,2018-02-18 02:00:00,9248,9342,-94,50,182,4
2,FlexPen Aspart 100 3ML CCH,2018-02-18 03:00:00,516,396,120,85,336,4
2,NovoMix 30 GLY (CCH),2018-02-18 03:00:00,516,396,120,85,336,4
2,NovoMix 30 GLY (CCH),2018-02-18 04:00:00,7972,7776,196,57,2258,4
2,NovoMix 30 GLY (CCH),2018-02-18 05:00:00,8659,8856,-197,1,4860,4
2,NovoMix 30 GLY (CCH),2018-02-18 06:00:00,8464,8208,256,15,428,4
2,NovoMix 30 GLY (CCH),2018-02-18 07:00:00,8652,8586,66,31,280,4
2,NovoMix 30 GLY (CCH),2018-02-18 08:00:00,9068,9126,-58,51,212,4
2,NovoMix 30 GLY (CCH),2018-02-18 09:00:00,9140,9018,122,118,362,4
2,NovoMix 30 GLY (CCH),2018-02-18 10:00:00,9268,9234,34,118,644,4
2,NovoMix 30 GLY (CCH),2018-02-18 11:00:00,9308,9234,74,147,664,4
2,NovoMix 30 GLY (CCH),2018-02-18 12:00:00,9439,9396,43,104,788,4
2,NovoMix 30 GLY (CCH),2018-02-18 13:00:00,8903,8856,47,54,358,4
2,NovoMix 30 GLY (CCH),2018-02-18 14:00:00,9060,9018,42,58,1090,4
2,NovoMix 30 GLY (CCH),2018-02-18 15:00:00,8364,8316,48,82,628,4
2,NovoMix 30 GLY (CCH),2018-02-18 16:00:00,10056,9990,66,110,640,4
2,NovoMix 30 GLY (CCH),2018-02-18 17:00:00,7680,7632,48,122,718,4
2,NovoMix 30 GLY (CCH),2018-02-18 18:00:00,9236,9180,56,79,780,4
2,NovoMix 30 GLY (CCH),2018-02-18 19:00:00,9035,8964,71,88,854,4
2,NovoMix 30 GLY (CCH),2018-02-18 20:00:00,8428,8370,58,94,1104,4
2,NovoMix 30 GLY (CCH),2018-02-18 21:00:00,8827,8802,25,105,678,4
2,NovoMix 30 GLY (CCH),2018-02-18 22:00:00,8512,8478,34,97,678,4
2,NovoMix 30 GLY (CCH),2018-02-18 23:00:00,7019,6966,53,136,462,3.25
2,NovoMix 30 GLY (CCH),2018-02-19 00:00:00,8132,8100,32,110,330,3
2,NovoMix 30 GLY (CCH),2018-02-19 01:00:00,8764,8694,70,173,500,3
2,NovoMix 30 GLY (CCH),2018-02-19 02:00:00,9476,9396,80,139,498,3
2,NovoMix 30 GLY (CCH),2018-02-19 03:00:00,9516,9504,12,127,604,3
2,NovoMix 30 GLY (CCH),2018-02-19 04:00:00,9248,9180,68,94,12774,3
2,NovoMix 30 GLY (CCH),2018-02-19 05:00:00,9232,9288,-56,77,200,3
2,NovoMix 30 GLY (CCH),2018-02-19 06:00:00,8364,8208,156,38,1116,3.2
2,NovoMix 30 GLY (CCH),2018-02-19 07:00:00,6328,6210,118,56,344,3
2,NovoMix 30 GLY (CCH),2018-02-19 08:00:00,0,54,-54,18,3230,3
2,NovoMix 30 GLY (CCH),2018-02-19 10:00:00,348,288,60,121,1978,3
2,NovoMix 30 GLY (CCH),2018-02-19 11:00:00,4804,4806,-2,2,4628,3
2,NovoMix 30 GLY (CCH),2018-02-19 12:00:00,4212,4212,0,26,264,3
2,NovoMix 30 GLY (CCH),2018-02-19 13:00:00,872,810,62,28,2724,3
2,NovoMix 30 GLY (CCH),2018-02-19 14:00:00,3232,3186,46,21,252,3.2
2,NovoMix 30 GLY (CCH),2018-02-19 15:00:00,5992,6048,-56,36,1182,3.2
2,NovoMix 30 GLY (CCH),2018-02-19 16:00:00,5672,5616,56,52,794,3
2,NovoMix 30 GLY (CCH),2018-02-19 17:00:00,4359,4266,93,65,780,3
2,NovoMix 30 GLY (CCH),2018-02-19 18:00:00,8828,8748,80,56,818,3
2,NovoMix 30 GLY (CCH),2018-02-19 19:00:00,7338,7236,102,2,7032,3
2,NovoMix 30 GLY (CCH),2018-02-19 20:00:00,8788,8748,40,7,124,3
2,NovoMix 30 GLY (CCH),2018-02-19 21:00:00,8644,8586,58,39,256,3
2,NovoMix 30 GLY (CCH),2018-02-19 22:00:00,6946,7344,-398,38,174,3.2
2,NovoMix 30 GLY (CCH),2018-02-19 23:00:00,0,36,-36,39,594,3.2
2,FlexPen Aspart 100 3ML CCH,2018-02-20 00:00:00,514,108,406,10,3292,3
2,FlexPen Aspart 100 3ML CCH,2018-02-20 01:00:00,10168,9936,232,48,494,3
2,FlexPen Aspart 100 3ML CCH,2018-02-20 02:00:00,10368,10368,0,61,350,3
2,FlexPen Aspart 100 3ML CCH,2018-02-20 03:00:00,9131,8910,221,32,462,3
2,FlexPen Aspart 100 3ML CCH,2018-02-20 04:00:00,2010,1836,174,52,382,3
2,FlexPen Aspart 100 3ML CCH,2018-02-20 05:00:00,8350,8208,142,43,344,3
2,FlexPen Aspart 100 3ML CCH,2018-02-20 06:00:00,9980,9882,98,48,1204,3.2
2,FlexPen Aspart 100 3ML CCH,2018-02-20 07:00:00,9747,9612,135,57,2158,3
2,FlexPen Aspart 100 3ML CCH,2018-02-20 08:00:00,9880,9828,52,87,416,3
2,FlexPen Aspart 100 3ML CCH,2018-02-20 09:00:00,8884,8748,136,28,230,3
2,FlexPen Aspart 100 3ML CCH,2018-02-20 10:00:00,7144,7020,124,36,830,3
2,FlexPen Aspart 100 3ML CCH,2018-02-20 11:00:00,6000,5940,60,39,1066,3
2,FlexPen Aspart 100 3ML CCH,2018-02-20 12:00:00,7315,7236,79,44,1286,3
2,FlexPen Aspart 100 3ML CCH,2018-02-20 13:00:00,10384,10476,-92,10,4586,3
2,FlexPen Aspart 100 3ML CCH,2018-02-20 14:00:00,8828,8802,26,27,356,3.2
2,FlexPen Aspart 100 3ML CCH,2018-02-20 15:00:00,7392,7128,264,47,600,3.2
2,FlexPen Aspart 100 3ML CCH,2018-02-20 16:00:00,7275,7398,-123,67,1174,3
2,FlexPen Aspart 100 3ML CCH,2018-02-20 17:00:00,268,216,52,29,2220,3
2,FlexPen Aspart 100 3ML CCH,2018-02-20 18:00:00,6255,5994,261,50,702,3
2,FlexPen Aspart 100 3ML CCH,2018-02-20 19:00:00,9212,9126,86,48,602,3
2,FlexPen Aspart 100 3ML CCH,2018-02-20 20:00:00,7468,7398,70,61,430,3
2,FlexPen Aspart 100 3ML CCH,2018-02-20 21:00:00,5232,5346,-114,42,470,3
2,FlexPen Aspart 100 3ML CCH,2018-02-20 22:00:00,6957,6804,153,69,624,3.2
2,FlexPen Aspart 100 3ML CCH,2018-02-20 23:00:00,8951,8856,95,126,1394,3.2
2,FlexPen Aspart 100 3ML CCH,2018-02-21 00:00:00,9604,9558,46,16,2830,3
2,FlexPen Aspart 100 3ML CCH,2018-02-21 01:00:00,9924,9882,42,30,2146,3
2,FlexPen Aspart 100 3ML CCH,2018-02-21 02:00:00,8484,8586,-102,36,28978,3
2,FlexPen Aspart 100 3ML CCH,2018-02-21 03:00:00,6860,6588,272,95,756,3
2,FlexPen Aspart 100 3ML CCH,2018-02-21 04:00:00,2332,2376,-44,107,478,3
2,FlexPen Aspart 100 3ML CCH,2018-02-21 05:00:00,4824,4752,72,70,382,3
2,FlexPen Aspart 100 3ML CCH,2018-02-21 06:00:00,6064,5922,142,86,524,3.2
2,FlexPen Aspart 100 3ML CCH,2018-02-21 14:00:00,164,54,110,19,1424,3.2
2,FlexPen Aspart 100 3ML CCH,2018-02-21 15:00:00,8224,8100,124,34,2958,3.2
2,FlexPen Aspart 100 3ML CCH,2018-02-21 16:00:00,8336,8316,20,32,376,3
2,FlexPen Aspart 100 3ML CCH,2018-02-21 17:00:00,2515,2952,-437,54,326,4
2,NovoMix 30 GLY (CCH),2018-02-21 18:00:00,2958,2376,582,74,332,4
2,NovoMix 30 GLY (CCH),2018-02-21 19:00:00,4587,4644,-57,39,554,4
2,NovoMix 30 GLY (CCH),2018-02-21 20:00:00,6736,6534,202,80,436,4
2,NovoMix 30 GLY (CCH),2018-02-21 21:00:00,9956,9774,182,35,282,4
2,NovoMix 30 GLY (CCH),2018-02-21 22:00:00,10040,9882,158,28,242,4
2,NovoMix 30 GLY (CCH),2018-02-21 23:00:00,9396,9288,108,60,450,4
2,NovoMix 30 GLY (CCH),2018-02-22 00:00:00,9444,9450,-6,48,302,4
2,NovoMix 30 GLY (CCH),2018-02-22 01:00:00,10080,9936,144,44,530,4
2,NovoMix 30 GLY (CCH),2018-02-22 02:00:00,10192,10044,148,47,412,4
2,NovoMix 30 GLY (CCH),2018-02-22 03:00:00,9624,9666,-42,62,1388,4
2,NovoMix 30 GLY (CCH),2018-02-22 04:00:00,10176,10098,78,16,1778,4
2,NovoMix 30 GLY (CCH),2018-02-22 05:00:00,10420,10422,-2,37,1452,4
2,NovoMix 30 GLY (CCH),2018-02-22 06:00:00,8828,8694,134,60,500,4
2,NovoMix 30 GLY (CCH),2018-02-22 07:00:00,6840,6858,-18,88,1034,4
2,NovoMix 30 GLY (CCH),2018-02-22 08:00:00,6316,6156,160,51,968,4
2,NovoMix 30 GLY (CCH),2018-02-22 09:00:00,6140,6048,92,32,192,4
2,NovoMix 30 GLY (CCH),2018-02-22 10:00:00,9646,9774,-128,43,300,4
2,NovoMix 30 GLY (CCH),2018-02-22 11:00:00,8536,8532,4,27,380,4
2,NovoMix 30 GLY (CCH),2018-02-22 12:00:00,7180,7020,160,43,346,4
2,NovoMix 30 GLY (CCH),2018-02-22 13:00:00,10724,10584,140,19,112,4
2,NovoMix 30 GLY (CCH),2018-02-22 14:00:00,9712,9558,154,30,408,4
2,NovoMix 30 GLY (CCH),2018-02-22 15:00:00,9672,9666,6,30,130,4
2,NovoMix 30 GLY (CCH),2018-02-22 16:00:00,10120,10044,76,21,1152,4
2,NovoMix 30 GLY (CCH),2018-02-22 17:00:00,8248,8262,-14,34,482,4
2,NovoMix 30 GLY (CCH),2018-02-22 18:00:00,9564,9450,114,36,112,4
2,NovoMix 30 GLY (CCH),2018-02-22 19:00:00,10060,10044,16,22,1120,4
2,NovoMix 30 GLY (CCH),2018-02-22 20:00:00,8388,8424,-36,34,662,4
2,NovoMix 30 GLY (CCH),2018-02-22 21:00:00,9040,8910,130,27,492,4
2,NovoMix 30 GLY (CCH),2018-02-22 22:00:00,10628,10476,152,38,1616,4
2,NovoMix 30 GLY (CCH),2018-02-22 23:00:00,7852,7830,22,17,1148,4
2,NovoMix 30 GLY (CCH),2018-02-23 00:00:00,9052,8964,88,43,336,4
2,NovoMix 30 GLY (CCH),2018-02-23 01:00:00,8944,8964,-20,47,3396,3.5
2,NovoMix 30 GLY (CCH),2018-02-23 02:00:00,5684,5598,86,30,222,3
2,NovoMix 30 GLY (CCH),2018-02-23 03:00:00,7420,7398,22,29,774,3
2,NovoMix 30 GLY (CCH),2018-02-23 04:00:00,10168,10044,124,36,712,3
2,NovoMix 30 GLY (CCH),2018-02-23 05:00:00,2786,3348,-562,21,596,3
2,NovoMix 30 GLY (CCH),2018-02-23 06:00:00,8374,7776,598,32,1818,3
2,NovoMix 30 GLY (CCH),2018-02-23 06:00:00,8374,7776,598,32,1818,3
2,Testmedium (CCH),2018-02-23 06:00:00,8374,7776,598,32,1818,3
2,NovoMix 30 GLY (CCH),2018-02-23 07:00:00,8712,8640,72,42,1660,3
2,NovoMix 30 GLY (CCH),2018-02-23 07:00:00,8712,8640,72,42,1660,3
2,Testmedium (CCH),2018-02-23 07:00:00,8712,8640,72,42,1660,3
2,NovoMix 30 GLY (CCH),2018-02-23 08:00:00,9718,9774,-56,55,3238,3
2,NovoMix 30 GLY (CCH),2018-02-23 08:00:00,9718,9774,-56,55,3238,3
2,Testmedium (CCH),2018-02-23 08:00:00,9718,9774,-56,55,3238,3
2,NovoMix 30 GLY (CCH),2018-02-23 09:00:00,7514,7344,170,74,600,3
2,NovoMix 30 GLY (CCH),2018-02-23 09:00:00,7514,7344,170,74,600,3
2,Testmedium (CCH),2018-02-23 09:00:00,7514,7344,170,74,600,3
2,NovoMix 30 GLY (CCH),2018-02-23 10:00:00,6966,6966,0,51,406,3
2,NovoMix 30 GLY (CCH),2018-02-23 10:00:00,6966,6966,0,51,406,3
2,Testmedium (CCH),2018-02-23 10:00:00,6966,6966,0,51,406,3
2,NovoMix 30 GLY (CCH),2018-02-23 11:00:00,5084,5130,-46,41,252,3
2,NovoMix 30 GLY (CCH),2018-02-23 11:00:00,5084,5130,-46,41,252,3
2,Testmedium (CCH),2018-02-23 11:00:00,5084,5130,-46,41,252,3
2,NovoMix 30 GLY (CCH),2018-02-23 12:00:00,9914,9828,86,32,346,3
2,NovoMix 30 GLY (CCH),2018-02-23 12:00:00,9914,9828,86,32,346,3
2,Testmedium (CCH),2018-02-23 12:00:00,9914,9828,86,32,346,3
2,NovoMix 30 GLY (CCH),2018-02-23 13:00:00,9806,9720,86,34,424,3
2,NovoMix 30 GLY (CCH),2018-02-23 13:00:00,9806,9720,86,34,424,3
2,Testmedium (CCH),2018-02-23 13:00:00,9806,9720,86,34,424,3
2,NovoMix 30 GLY (CCH),2018-02-23 14:00:00,8968,8856,112,51,1866,3
2,NovoMix 30 GLY (CCH),2018-02-23 14:00:00,8968,8856,112,51,1866,3
2,Testmedium (CCH),2018-02-23 14:00:00,8968,8856,112,51,1866,3
2,NovoMix 30 GLY (CCH),2018-02-23 15:00:00,10516,10422,94,32,418,3
2,NovoMix 30 GLY (CCH),2018-02-23 15:00:00,10516,10422,94,32,418,3
2,Testmedium (CCH),2018-02-23 15:00:00,10516,10422,94,32,418,3
2,NovoMix 30 GLY (CCH),2018-02-23 16:00:00,9814,9990,-176,36,698,3
2,NovoMix 30 GLY (CCH),2018-02-23 16:00:00,9814,9990,-176,36,698,3
2,Testmedium (CCH),2018-02-23 16:00:00,9814,9990,-176,36,698,3
2,NovoMix 30 GLY (CCH),2018-02-23 17:00:00,9656,9450,206,37,336,3
2,NovoMix 30 GLY (CCH),2018-02-23 17:00:00,9656,9450,206,37,336,3
2,Testmedium (CCH),2018-02-23 17:00:00,9656,9450,206,37,336,3
2,NovoMix 30 GLY (CCH),2018-02-23 18:00:00,5682,5670,12,58,1516,3
2,NovoMix 30 GLY (CCH),2018-02-23 18:00:00,5682,5670,12,58,1516,3
2,Testmedium (CCH),2018-02-23 18:00:00,5682,5670,12,58,1516,3
2,NovoMix 30 GLY (CCH),2018-02-23 19:00:00,9250,9072,178,43,516,3
2,NovoMix 30 GLY (CCH),2018-02-23 19:00:00,9250,9072,178,43,516,3
2,Testmedium (CCH),2018-02-23 19:00:00,9250,9072,178,43,516,3
2,NovoMix 30 GLY (CCH),2018-02-23 20:00:00,9112,9126,-14,40,436,3
2,NovoMix 30 GLY (CCH),2018-02-23 20:00:00,9112,9126,-14,40,436,3
2,Testmedium (CCH),2018-02-23 20:00:00,9112,9126,-14,40,436,3
2,NovoMix 30 GLY (CCH),2018-02-23 21:00:00,9560,9396,164,14,3628,3
2,NovoMix 30 GLY (CCH),2018-02-23 21:00:00,9560,9396,164,14,3628,3
2,Testmedium (CCH),2018-02-23 21:00:00,9560,9396,164,14,3628,3
2,NovoMix 30 GLY (CCH),2018-02-23 22:00:00,6656,6804,-148,1,14340,2.57142857142857
2,NovoMix 30 GLY (CCH),2018-02-23 22:00:00,6656,6804,-148,1,14340,2.57142857142857
2,Testmedium (CCH),2018-02-23 22:00:00,6656,6804,-148,1,14340,2.57142857142857
2,NovoMix 30 GLY (CCH),2018-02-23 23:00:00,9324,9018,306,195,612,2.66666666666667
2,NovoMix 30 GLY (CCH),2018-02-23 23:00:00,9324,9018,306,195,612,2.66666666666667
2,Testmedium (CCH),2018-02-23 23:00:00,9324,9018,306,195,612,2.66666666666667
2,NovoMix 30 GLY (CCH),2018-02-24 00:00:00,9768,9774,-6,130,944,2.66666666666667
2,NovoMix 30 GLY (CCH),2018-02-24 00:00:00,9768,9774,-6,130,944,2.66666666666667
2,Testmedium (CCH),2018-02-24 00:00:00,9768,9774,-6,130,944,2.66666666666667
2,NovoMix 30 GLY (CCH),2018-02-24 01:00:00,5812,5670,142,109,584,2.66666666666667
2,NovoMix 30 GLY (CCH),2018-02-24 01:00:00,5812,5670,142,109,584,2.66666666666667
2,Testmedium (CCH),2018-02-24 01:00:00,5812,5670,142,109,584,2.66666666666667
2,NovoMix 30 GLY (CCH),2018-02-24 12:00:00,328,72,256,27,256,2.66666666666667
2,NovoMix 30 GLY (CCH),2018-02-24 12:00:00,328,72,256,27,256,2.66666666666667
2,Testmedium (CCH),2018-02-24 12:00:00,328,72,256,27,256,2.66666666666667
2,NovoMix 30 GLY (CCH),2018-02-24 13:00:00,3628,3924,-296,45,266,2.66666666666667
2,NovoMix 30 GLY (CCH),2018-02-24 13:00:00,3628,3924,-296,45,266,2.66666666666667
2,Testmedium (CCH),2018-02-24 13:00:00,3628,3924,-296,45,266,2.66666666666667
2,NovoMix 30 GLY (CCH),2018-02-24 14:00:00,3861,3294,567,57,466,2.66666666666667
2,NovoMix 30 GLY (CCH),2018-02-24 15:00:00,7783,7776,7,31,292,2.66666666666667
2,NovoMix 30 GLY (CCH),2018-02-24 16:00:00,10508,10422,86,15,316,2.66666666666667
2,NovoMix 30 GLY (CCH),2018-02-24 17:00:00,10124,10098,26,44,316,2.66666666666667
2,NovoMix 30 GLY (CCH),2018-02-24 18:00:00,9283,9234,49,91,1344,2.66666666666667
2,NovoMix 30 GLY (CCH),2018-02-24 19:00:00,9720,9666,54,48,804,2.66666666666667
2,NovoMix 30 GLY (CCH),2018-02-24 20:00:00,10544,10422,122,125,690,2.66666666666667
2,NovoMix 30 GLY (CCH),2018-02-24 21:00:00,10128,10098,30,25,362,2.66666666666667
2,NovoMix 30 GLY (CCH),2018-02-24 22:00:00,10276,10314,-38,28,168,2.66666666666667
2,NovoMix 30 GLY (CCH),2018-02-24 23:00:00,8368,8262,106,44,278,2.66666666666667
2,NovoMix 30 GLY (CCH),2018-02-25 00:00:00,10156,10098,58,39,208,2.66666666666667
2,NovoMix 30 GLY (CCH),2018-02-25 01:00:00,10306,10260,46,27,232,2.66666666666667
2,NovoMix 30 GLY (CCH),2018-02-25 02:00:00,10256,10206,50,28,546,2.66666666666667
2,NovoMix 30 GLY (CCH),2018-02-25 03:00:00,10456,10422,34,36,238,2.66666666666667
2,NovoMix 30 GLY (CCH),2018-02-25 04:00:00,10487,10422,65,33,424,2.66666666666667
2,NovoMix 30 GLY (CCH),2018-02-25 05:00:00,9440,9342,98,83,1408,2.66666666666667
2,NovoMix 30 GLY (CCH),2018-02-25 06:00:00,10339,10368,-29,46,2444,2.66666666666667
2,NovoMix 30 GLY (CCH),2018-02-25 07:00:00,9516,9504,12,18,438,2.66666666666667
2,NovoMix 30 GLY (CCH),2018-02-25 08:00:00,6760,6696,64,43,286,2.66666666666667
2,NovoMix 30 GLY (CCH),2018-02-25 09:00:00,3392,3294,98,37,164,2.66666666666667
2,NovoMix 30 GLY (CCH),2018-02-25 10:00:00,9920,9936,-16,41,600,2.66666666666667
2,NovoMix 30 GLY (CCH),2018-02-25 11:00:00,9896,9828,68,42,544,2.66666666666667
2,NovoMix 30 GLY (CCH),2018-02-25 12:00:00,10056,9990,66,53,338,3
2,NovoMix 30 GLY (CCH),2018-02-25 13:00:00,9299,9180,119,39,678,4
2,NovoMix 30 GLY (CCH),2018-02-25 14:00:00,9780,9774,6,23,120,4
2,NovoMix 30 GLY (CCH),2018-02-25 15:00:00,9820,9828,-8,35,336,4
2,NovoMix 30 GLY (CCH),2018-02-25 16:00:00,8790,8748,42,42,430,4
2,NovoMix 30 GLY (CCH),2018-02-25 17:00:00,10388,10314,74,63,344,4
2,NovoMix 30 GLY (CCH),2018-02-25 18:00:00,10040,9936,104,28,176,4
2,NovoMix 30 GLY (CCH),2018-02-25 19:00:00,9840,9774,66,24,4212,4
2,NovoMix 30 GLY (CCH),2018-02-25 20:00:00,9820,9774,46,26,208,4
2,NovoMix 30 GLY (CCH),2018-02-25 21:00:00,10587,10584,3,47,226,4
2,NovoMix 30 GLY (CCH),2018-02-25 22:00:00,3526,4050,-524,38,520,4
2,FlexPen Aspart 100 3ML CCH,2018-02-25 23:00:00,5222,4698,524,30,214,3.66666666666667
2,FlexPen Aspart 100 3ML CCH,2018-02-26 00:00:00,10404,10368,36,26,256,3.5
2,FlexPen Aspart 100 3ML CCH,2018-02-26 01:00:00,9448,9342,106,23,220,3.5
2,FlexPen Aspart 100 3ML CCH,2018-02-26 02:00:00,10500,10422,78,21,486,3.5
2,FlexPen Aspart 100 3ML CCH,2018-02-26 03:00:00,10288,10206,82,21,676,3.5
2,FlexPen Aspart 100 3ML CCH,2018-02-26 04:00:00,10488,10476,12,37,490,3.5
2,FlexPen Aspart 100 3ML CCH,2018-02-26 05:00:00,10236,10152,84,27,234,3.5
2,FlexPen Aspart 100 3ML CCH,2018-02-26 06:00:00,8548,8478,70,128,752,3.5
2,FlexPen Aspart 100 3ML CCH,2018-02-26 07:00:00,9348,9396,-48,137,1044,3.5
2,FlexPen Aspart 100 3ML CCH,2018-02-26 08:00:00,10472,10368,104,115,740,3.66666666666667
2,FlexPen Aspart 100 3ML CCH,2018-02-26 09:00:00,8616,8532,84,90,1006,4
2,FlexPen Aspart 100 3ML CCH,2018-02-26 10:00:00,9916,9882,34,88,834,4
2,FlexPen Aspart 100 3ML CCH,2018-02-26 11:00:00,8531,8424,107,87,418,4
2,FlexPen Aspart 100 3ML CCH,2018-02-26 12:00:00,7588,7830,-242,96,388,4
2,FlexPen Aspart 100 3ML CCH,2018-02-26 13:00:00,10388,10206,182,95,464,4
2,FlexPen Aspart 100 3ML CCH,2018-02-26 14:00:00,7234,7128,106,71,440,4
2,FlexPen Aspart 100 3ML CCH,2018-02-26 15:00:00,10488,10368,120,112,632,4
2,FlexPen Aspart 100 3ML CCH,2018-02-26 16:00:00,9612,9612,0,87,502,4
2,FlexPen Aspart 100 3ML CCH,2018-02-26 17:00:00,9444,9342,102,106,480,4
2,FlexPen Aspart 100 3ML CCH,2018-02-26 18:00:00,9448,9396,52,91,570,4
2,FlexPen Aspart 100 3ML CCH,2018-02-26 19:00:00,5540,5724,-184,81,528,4
2,FlexPen Aspart 100 3ML CCH,2018-02-26 20:00:00,4938,4644,294,45,2474,4
2,FlexPen Aspart 100 3ML CCH,2018-02-26 21:00:00,10588,10584,4,93,424,4
2,FlexPen Aspart 100 3ML CCH,2018-02-26 22:00:00,9200,9180,20,91,654,4
2,FlexPen Aspart 100 3ML CCH,2018-02-26 23:00:00,10498,10584,-86,91,486,4
2,FlexPen Aspart 100 3ML CCH,2018-02-27 00:00:00,9044,8748,296,112,560,3.5
2,FlexPen Aspart 100 3ML CCH,2018-02-27 01:00:00,1828,1980,-152,93,442,3.5
2,FlexPen Aspart 100 3ML CCH,2018-02-27 01:00:00,1828,1980,-152,93,442,3.5
2,FlexPen Aspart 100 3ML CCH,2018-02-27 02:00:00,10136,9882,254,99,3384,3.5
2,FlexPen Aspart 100 3ML CCH,2018-02-27 03:00:00,9791,9720,71,201,37726,3.5
2,FlexPen Aspart 100 3ML CCH,2018-02-27 04:00:00,10515,10530,-15,53,436,3.5
2,FlexPen Aspart 100 3ML CCH,2018-02-27 05:00:00,10458,10314,144,41,546,3.5
2,FlexPen Aspart 100 3ML CCH,2018-02-27 06:00:00,8740,8748,-8,54,518,3.5
2,FlexPen Aspart 100 3ML CCH,2018-02-27 07:00:00,9568,9504,64,26,660,3.5
2,FlexPen Aspart 100 3ML CCH,2018-02-27 08:00:00,9654,9612,42,23,284,4
2,FlexPen Aspart 100 3ML CCH,2018-02-27 09:00:00,8273,8208,65,34,452,4
2,FlexPen Aspart 100 3ML CCH,2018-02-27 10:00:00,9383,9342,41,27,158,4
2,FlexPen Aspart 100 3ML CCH,2018-02-27 11:00:00,9471,9396,75,17,300,4
2,FlexPen Aspart 100 3ML CCH,2018-02-27 12:00:00,8992,8964,28,26,290,4
2,FlexPen Aspart 100 3ML CCH,2018-02-27 13:00:00,10340,10260,80,96,558,4
2,FlexPen Aspart 100 3ML CCH,2018-02-27 14:00:00,9664,9558,106,36,242,4
2,FlexPen Aspart 100 3ML CCH,2018-02-27 15:00:00,10618,10638,-20,48,1876,4
2,FlexPen Aspart 100 3ML CCH,2018-02-27 16:00:00,10242,10206,36,64,1344,4
2,FlexPen Aspart 100 3ML CCH,2018-02-27 17:00:00,10424,10314,110,89,942,4
2,FlexPen Aspart 100 3ML CCH,2018-02-27 18:00:00,10158,10152,6,82,866,4
2,FlexPen Aspart 100 3ML CCH,2018-02-27 19:00:00,10548,10530,18,132,676,4
2,FlexPen Aspart 100 3ML CCH,2018-02-27 20:00:00,8390,8370,20,149,442,4
2,FlexPen Aspart 100 3ML CCH,2018-02-27 21:00:00,8910,8802,108,155,410,4
2,FlexPen Aspart 100 3ML CCH,2018-02-27 22:00:00,8838,8856,-18,129,686,4
2,FlexPen Aspart 100 3ML CCH,2018-02-27 23:00:00,9520,9396,124,169,464,4
2,FlexPen Aspart 100 3ML CCH,2018-02-28 00:00:00,8524,8316,208,239,554,4
2,FlexPen Aspart 100 3ML CCH,2018-02-28 01:00:00,9300,9396,-96,147,1082,3.5
2,FlexPen Aspart 100 3ML CCH,2018-02-28 02:00:00,5434,5976,-542,104,1274,3.5
2,NovoMix 30 GLY (CCH),2018-02-28 03:00:00,7638,7020,618,159,476,3.5
2,NovoMix 30 GLY (CCH),2018-02-28 04:00:00,8876,8856,20,105,812,3.5
2,NovoMix 30 GLY (CCH),2018-02-28 05:00:00,9956,9936,20,47,490,3.5
2,NovoMix 30 GLY (CCH),2018-02-28 06:00:00,9384,9342,42,58,468,3.5
2,NovoMix 30 GLY (CCH),2018-02-28 07:00:00,9508,9450,58,50,1074,3.5
2,NovoMix 30 GLY (CCH),2018-02-28 08:00:00,9715,9720,-5,50,282,3.5
2,NovoMix 30 GLY (CCH),2018-02-28 09:00:00,4284,4158,126,59,648,3.5
2,NovoMix 30 GLY (CCH),2018-02-28 10:00:00,9067,8964,103,73,794,3.5
2,NovoMix 30 GLY (CCH),2018-02-28 11:00:00,4568,4590,-22,56,366,3.5
2,NovoMix 30 GLY (CCH),2018-02-28 12:00:00,5248,5022,226,78,386,3.5
2,NovoMix 30 GLY (CCH),2018-02-28 13:00:00,8312,8316,-4,78,672,3.5
2,NovoMix 30 GLY (CCH),2018-02-28 14:00:00,8176,8208,-32,73,618,3.5
2,NovoMix 30 GLY (CCH),2018-02-28 15:00:00,9247,9126,121,59,708,3.5
2,NovoMix 30 GLY (CCH),2018-02-28 16:00:00,9856,9774,82,27,40290,3.5
2,NovoMix 30 GLY (CCH),2018-02-28 17:00:00,10112,10098,14,37,624,3.5
2,NovoMix 30 GLY (CCH),2018-02-28 18:00:00,9488,9396,92,33,29162,3.5
2,NovoMix 30 GLY (CCH),2018-02-28 19:00:00,9996,9990,6,13,502,3.5
2,NovoMix 30 GLY (CCH),2018-02-28 20:00:00,9200,9234,-34,55,1674,3.5
2,NovoMix 30 GLY (CCH),2018-02-28 21:00:00,10532,10314,218,35,372,3.5
2,NovoMix 30 GLY (CCH),2018-02-28 22:00:00,5794,5994,-200,2,4420,3.5
2,NovoMix 30 GLY (CCH),2018-03-01 06:00:00,2948,2808,140,14,128,3.5
2,NovoMix 30 GLY (CCH),2018-03-01 07:00:00,9428,9342,86,12,152,3.5
2,NovoMix 30 GLY (CCH),2018-03-01 08:00:00,8196,8154,42,35,462,3.5
2,NovoMix 30 GLY (CCH),2018-03-01 09:00:00,9684,9666,18,36,542,3.5
2,NovoMix 30 GLY (CCH),2018-03-01 10:00:00,8772,8802,-30,30,668,3.5
2,NovoMix 30 GLY (CCH),2018-03-01 11:00:00,9972,9774,198,19,116830,3.5
2,NovoMix 30 GLY (CCH),2018-03-01 12:00:00,9624,9666,-42,22,400,3.5
2,NovoMix 30 GLY (CCH),2018-03-01 13:00:00,9198,9072,126,31,670,3.5
2,NovoMix 30 GLY (CCH),2018-03-01 14:00:00,9680,9558,122,31,688,3.5
2,NovoMix 30 GLY (CCH),2018-03-01 15:00:00,9720,9666,54,27,132556,3.5
2,NovoMix 30 GLY (CCH),2018-03-01 16:00:00,10412,10422,-10,1,36598,3.5
2,NovoMix 30 GLY (CCH),2018-03-01 17:00:00,9111,8964,147,24,1310,3.5
2,NovoMix 30 GLY (CCH),2018-03-01 18:00:00,9751,9828,-77,18,1876,3.5
2,NovoMix 30 GLY (CCH),2018-03-01 19:00:00,8944,8802,142,21,386,3.5
2,NovoMix 30 GLY (CCH),2018-03-01 20:00:00,5322,5886,-564,14,2228,3.5
